<span class="LineNumber"> 001 </span>	          <B>เราเห็นหมู่มนุษย์ที่มีทรัพย์ในโลกนี้     ได้ทรัพย์แล้ว
<span class="LineNumber"> 002 </span>	ไม่ให้ทานเพราะความลุ่มหลง  ได้ทรัพย์แล้วทำการสั่งสม
<span class="LineNumber"> 003 </span>	ไว้  และปรารถนาอยากได้ยิ่งขึ้นไป   พระราชากดขี่ช่วง
<span class="LineNumber"> 004 </span>	ชิงเอาแผ่นดิน      ครอบครองแผ่นดินอันมีสาครเป็นที่สุด
<span class="LineNumber"> 005 </span>	ตลอดฝั่งสมุทรข้างนี้แล้ว    ไม่รู้จักอิ่ม    ยังปรารถนาจัก
<span class="LineNumber"> 006 </span>	ครอบครองฝั่งสมุทรข้างโน้นอีกต่อไป.  พระราชาก็ดีมนุษย์
<span class="LineNumber"> 007 </span>	เหล่าอื่นเป็นอันมากก็ดี   ผู้ยังไม่ปราศจากตัณหา  ย่อมเข้า
<span class="LineNumber"> 008 </span>	ถึงความตาย     ยังไม่เต็มความประสงค์    ก็พากันละทิ้ง
<span class="LineNumber"> 009 </span>	ร่างกายไป     ความอิ่มด้วยกามทั้งหลายย่อมไม่มีในโลก
<span class="LineNumber"> 010 </span>	เลย  หมู่ญาติพากันสยายผมร้องไห้คร่ำครวญถึงผู้นั้นและ
<span class="LineNumber"> 011 </span> 	รำพันว่า  ทำอย่างไรหนอ   พวกญาติของเราจึงจะไม่ตาย
<span class="LineNumber"> 012 </span>	ครั้นพวกญาติตายแล้ว      ก็เอาผ้าห่อนำไปเผาเสียที่เชิง
<span class="LineNumber"> 013 </span> 	ตะกอน   ผู้ที่ตายไปนั้นถูกเขาแทงด้วยหลาว   เผาด้วยไฟ
<span class="LineNumber"> 014 </span>	ละโภคะทั้งหลาย   มีแต่ผ้าผืนเดียวติดตัวไป   เมื่อบุคคล
<span class="LineNumber"> 015 </span> 	จะตาย        ย่อมไม่มีญาติหรือมิตรสหายช่วยต้านทานได้
<span class="LineNumber"> 016 </span>	พวกที่รับมรดกก็มาขนเอาทรัพย์ของผู้ตายนั้นไป     ส่วน
<span class="LineNumber"> 017 </span> 	สัตว์ที่ตายย่อมไปตามยถากรรม        เมื่อตายไม่มีทรัพย์
<span class="LineNumber"> 018 </span>	สมบัติอะไร ๆ   คือ พวกบุตร  ภรรยา  ทรัพย์   แว่นแคว้น
<span class="LineNumber"> 019 </span> 	 สิ่งใด ๆ  จะติดตามไปได้เลย     บุคคลจะได้อายุยืนเพราะ
<span class="LineNumber"> 020 </span>	ทรัพย์ก็หาไม่   จะละความแก่รูปแม้เพราะทรัพย์ก็หาไม่.
<span class="LineNumber"> 021 </span>        	          นักปราชญ์ทั้งหลายกล่าวชีวิตนั้นแล  ว่าเป็นของน้อย 
<span class="LineNumber"> 022 </span>    	ไม่ยั่งยืน    มีความแปรปรวนเป็นธรรมดา   ทั้งคนมั่งมีและ</B>
