<span class="LineNumber"> 001 </span> 	<B>ยินดีในกาม   เพราะว่าผู้ไม่ประมาทเพ่งพินิจอยู่  ย่อมถึง
<span class="LineNumber"> 002 </span>	ความสุขอันไพบูลย์    การที่เรามาสู่สำนักของพระศาสดา
<span class="LineNumber"> 003 </span> 	เป็นการมาดีแล้ว   มิใช่ว่าเป็นการมาไม่ดี  การที่เราคิดจะ
<span class="LineNumber"> 004 </span>	บวชในสำนักของพระศาสดานี้       ก็ไม่ใช่เป็นความคิดที่
<span class="LineNumber"> 005 </span> 	เลวเลย  เพราะเป็นการเข้าถึงธรรมอันประเสริฐ  ในธรรม
<span class="LineNumber"> 006 </span>	ทั้งหลายที่พระศาสดาทรงจำแนกดีแล้ว        การที่เรามาสู่
<span class="LineNumber"> 007 </span> 	สำนักของพระศาสดานี้    เป็นการมาดีแล้ว    มิใช่ว่าเป็น
<span class="LineNumber"> 008 </span>	การมาไม่ดี        การที่เราคิดจะมาบวชในสำนักของพระ-
<span class="LineNumber"> 009 </span> 	ศาสดานี้     ก็ไม่ใช่เป็นความคิดที่เลวเลย     เราได้บรรลุ
<span class="LineNumber"> 010 </span>	วิชชา  ๓  ตามลำดับ ได้ทำตามคำสั่งสอนของพระพุทธเจ้า
<span class="LineNumber"> 011 </span>  	เสร็จแล้ว   แต่ก่อนเราอยู่ในป่า   โคนไม้   ภูเขา  หรือใน
<span class="LineNumber"> 012 </span>	ถ้ำทุก ๆ แห่ง  มีใจหวาดเสียวอยู่เป็นนิตย์  เราผู้อันพระ-
<span class="LineNumber"> 013 </span> 	ศาสดาทรงอนุเคราะห์แล้วไม่ไปในบ่วงมาร   จะยืน  เดิน
<span class="LineNumber"> 014 </span>	นั่ง  นอนก็เป็นสุข    เมื่อก่อนเรามีเชื้อชาติเป็นพราหมณ์
<span class="LineNumber"> 015 </span> 	มีครรภ์เป็นที่ถือปฏิสนธิบริสุทธิ์ทั้งหลายฝ่าย   บัดนี้   เราเป็น
<span class="LineNumber"> 016 </span>	โอรสของพระสุคตศาสดา  ผู้เป็นพระธรรมราชา  เราเป็น
<span class="LineNumber"> 017 </span>  	ผู้ปราศจากตัณหาแล้ว   ไม่ถือมั่น   คุ้มครองทวาร  สำรวม
<span class="LineNumber"> 018 </span>	ดีแล้ว  เราตัดรากเหง้าของทุกข์ได้แล้ว  บรรลุถึงความสิ้น
<span class="LineNumber"> 019 </span>  	อาสวะแล้ว  เรามีความคุ้นเคยกับพระศาสดา  ทำตามคำ
<span class="LineNumber"> 020 </span>	สอนของพระพุทธเจ้าเสร็จแล้ว       ปลงภาระอันหนักลง
<span class="LineNumber"> 021 </span>  	แล้ว  ถอนตัณหาเครื่องนำไปสู่ภพขึ้นแล้ว.</B>
<span class="LineNumber"> 022 </span>                                                    <I>จบองคุลิมาลเถรคาถา</I>
