<span class="LineNumber"> 001 </span> 	<B>ศาสนานี้      ไม่ควรมีกิเลสเครื่องตรึงใจ     ควรมีแต่ความ
<span class="LineNumber"> 002 </span>	เพียรชอบ     ละนิวรณ์แล้วเป็นผู้บริสุทธิ์      และละมานะ
<span class="LineNumber"> 003 </span> 	โดยไม่เหลือแล้ว     เป็นผู้สงบระงับ     บรรลุถึงที่สุดแห่ง
<span class="LineNumber"> 004 </span>	วิชชาได้.</B>
<span class="LineNumber"> 005 </span>        	<B>ข้าพเจ้าเร่าร้อนเพราะกามราคะ  และจิตใจของข้าพเจ้า
<span class="LineNumber"> 006 </span> 	ก็เร่าร้อนเพราะกามราคะเหมือนกัน      ดูก่อนท่านผู้สาวก
<span class="LineNumber"> 007 </span>	พระโคดม    ขอพระคุณจงกรุณาบอกธรรมเครื่องดับความ
<span class="LineNumber"> 008 </span>  	เร่าร้อนด้วยเถิด.</B>
<span class="LineNumber"> 009 </span>	        <B>จิตของท่านเร่าร้อนก็เพราะความสำคัญผิด     เพราะ-
<span class="LineNumber"> 010 </span>	ฉะนั้น  ท่านจงละสุภนิมิตอันประกอบด้วยราคะเสีย  ท่าน
<span class="LineNumber"> 011 </span>	จงอบรมจิตให้มีอารมณ์เป็นอันเดียว  ตั้งมั่นเด็ดเดี่ยว   ด้วย
<span class="LineNumber"> 012 </span>	การพิจารณาสิ่งทั้งปวงว่าไม่สวยงาม  จงอบรมกายคตาสติ
<span class="LineNumber"> 013 </span>	จงเป็นผู้มากไปด้วยความเบื่อหน่าย       ท่านจงเจริญอนิ-
<span class="LineNumber"> 014 </span>	มิตตานุปัสสนา  (คืออนิจจานุปัสสนา)    จงตัดอนุสัยคือ
<span class="LineNumber"> 015 </span>	มานะเสีย   แต่นั้นท่านจักเป็นผู้สงบระงับเที่ยวไป   เพราะ
<span class="LineNumber"> 016 </span>	ละมานะได้.</B>
<span class="LineNumber"> 017 </span>	        <B>บุคคลควรพูดแต่วาจาที่ไม่ทำตนให้เดือดร้อน     อนึ่ง
<span class="LineNumber"> 018 </span> 	วาจาใดไม่เบียดเบียนผู้อื่น    วาจานั้นแลเป็นวาจาสุภาษิต
<span class="LineNumber"> 019 </span>	บุคคลควรพูดแต่วาจาที่น่ารัก  ทั้งเป็นวาจาที่ทำให้ร่าเริงได้
<span class="LineNumber"> 020 </span>  	ไม่พึงยึดถือวาจาที่ชั่วช้าของคนอื่น    พึงกล่าวแต่วาจาอัน
<span class="LineNumber"> 021 </span>	เป็นที่รัก.   คำสัตย์แลเป็นวาจาที่ไม่ตาย    ธรรมนี้เป็นของ
<span class="LineNumber"> 022 </span> 	เก่า   สัตบุรุษทั้งหลายตั้งอยู่แล้วในคำสัตย์        ทั้งที่เป็น</B>
