<span class="LineNumber"> 001 </span>                            <B>เวลานั้น     เราได้ยินเสียงจึงแหงนขึ้นไป
<span class="LineNumber"> 002 </span>	ดู  ได้เห็นพระผู้นำโลก 
<span class="LineNumber"> 003 </span>                            เรายืนอยู่ในสระโบกขรณีนั่นแหละ  ได้
<span class="LineNumber"> 004 </span>	ทูลอ้อนวอนพระผู้นำโลกว่า  น้ำหวานน้ำนมและ
<span class="LineNumber"> 005 </span>	เนยใสกำลังไหลจากเหง้าบัว 
<span class="LineNumber"> 006 </span>                            ขอพระพุทธเจ้าผู้มีพระปัญญาจักษุโปรด
<span class="LineNumber"> 007 </span>	ทรงรับเพื่ออนุเคราะห์แก่ข้าพระองค์เถิด    ลำดับ
<span class="LineNumber"> 008 </span>	นั้นพระสัมพุทธเจ้าผู้ศาสดา     ทรงประกอบด้วย
<span class="LineNumber"> 009 </span>	พระกรุณา  มียศใหญ่  มีพระปัญญาจักษุ   เสด็จ
<span class="LineNumber"> 010 </span>	ลงจากอากาศมารับภิกษาของเรา    เพื่อความอนุ-
<span class="LineNumber"> 011 </span>	เคราะห์    ครั้นแล้วได้ทรงทำอนุโมทนาแก่เราว่า
<span class="LineNumber"> 012 </span>                            แน่ะ  ท่านผู้มีบุญใหญ่   ท่านจงเป็นผู้มี 
<span class="LineNumber"> 013 </span>	ความสุขเถิด   คติจงสำเร็จแก่ท่าน    ด้วยการให้
<span class="LineNumber"> 014 </span>	เหง้าบัวเป็นทานนี้   ท่านจงได้สุขอันไพบูลย์
<span class="LineNumber"> 015 </span>                            ครั้นพระสัมพุทธชินเจ้าพระนามว่าปทุมุต-
<span class="LineNumber"> 016 </span>	ตระตรัสฉะนี้แล้ว    ได้ทรงรับภิกษาแล้วเสด็จไป
<span class="LineNumber"> 017 </span>	ในอากาศ
<span class="LineNumber"> 018 </span>                            ลำดับนั้น      เราเก็บเหง้าบัวจากสระนั้น
<span class="LineNumber"> 019 </span>	กลับมายังอาศรม    วางเหง้าบัวไว้บนต้นไม้ระลึก
<span class="LineNumber"> 020 </span>	ถึงทานของเรา</B>
