<span class="LineNumber"> 001 </span>                             <B> พระสุเมธพุทธเจ้า  พระองค์นั้น  ผู้ควร
<span class="LineNumber"> 002 </span>	รับเครื่องบูชา  ประทับนั่งในท่ามกลางพระภิกษุ
<span class="LineNumber"> 003 </span>	สงฆ์แล้ว  จะตรัสพระดำรัส  จึงตรัสพระคาถา
<span class="LineNumber"> 004 </span>	เหล่านี้  ว่า 
<span class="LineNumber"> 005 </span>                              บุคคลใด  อังคาสเราด้วยข้าวและน้ำ ให้
<span class="LineNumber"> 006 </span>	เราเหล่านี้ทั้งหมดอิ่มพอแล้ว  เราจะสรรเสริญผู้นั้น
<span class="LineNumber"> 007 </span>	พวกท่านจงฟังเรากล่าวเถิด.
<span class="LineNumber"> 008 </span>                              ตลอดกาล  ๑,๘๐๐  กัป  ผู้นั้น  จักชื่นชม
<span class="LineNumber"> 009 </span>	ยินดีอยู่ในเทวโลก  จักชื่นชมอยู่ในความเป็น
<span class="LineNumber"> 010 </span>	พระราชา  ๑,๐๐๐  ครั้ง  แล้วจักเป็นพระเจ้าจักร-
<span class="LineNumber"> 011 </span>	พรรดิ.
<span class="LineNumber"> 012 </span>                              เมื่ออุบัติในกำเนิดใด ก็อุบัติแต่ในกำเนิด
<span class="LineNumber"> 013 </span>	เทวดาและมนุษย์เท่านั้น  เครื่องมุงบังอันสำเร็จ
<span class="LineNumber"> 014 </span>	ด้วยทองล้วน ก็จักกั้นอยู่เบื้องบนเขา.
<span class="LineNumber"> 015 </span>                              ในกัปที่สามหมื่น  พระมหาบุรุษ  พระ-
<span class="LineNumber"> 016 </span>	นามว่า  โคตมะ  โดยพระโคตร  จักทรงสมภพใน
<span class="LineNumber"> 017 </span>	พระราชวงศ์แห่งพระเจ้าโอกกากราช  จักเป็น
<span class="LineNumber"> 018 </span>	พระศาสดาในโลก.
<span class="LineNumber"> 019 </span>                              เขาจักเป็นทายาทในธรรมของพระองค์
<span class="LineNumber"> 020 </span>	จักเป็นพระโอรส  โดยธรรมเนรมิต  เพราะกำหนด
<span class="LineNumber"> 021 </span>	รู้อาสวะทั้งสิ้นแล้ว  จักเป็นผู้ไม่มีอาสวะปรินิพ-
<span class="LineNumber"> 022 </span>	พาน. </B>
