<span class="LineNumber"> 001 </span> [๑๑๘] ๘ กูฏาคาเร จ ปาสาเท      ปลฺลงฺเก โคณสณฺ€ิเต ๑   
<span class="LineNumber"> 002 </span>	  ปฺจงฺคิเกน ตุริเยน        รมสิ สุปฺปวาทิเต ฯ   
<span class="LineNumber"> 003 </span>	  ตโต รตฺยา วิวสาเน ๒    สุริยุคฺคมนํ ๓ ปติ   
<span class="LineNumber"> 004 </span>	  อปวิฏฺโ€ ๔ สุสานสฺมึ      พหุํ ทุกฺขํ นิคจฺฉสิ ฯ  
<span class="LineNumber"> 005 </span>	  กินฺนุ กาเยน วาจาย       มนสา ทุกฺกฏํ กตํ   
<span class="LineNumber"> 006 </span>	  กิสฺส กมฺมวิปาเกน         อิทํ ทุกฺขํ นิคจฺฉสีติ ฯ  
<span class="LineNumber"> 007 </span>	  อหํ ราชคเห รมฺเม        รมณีเย คิริพฺพเช  
<span class="LineNumber"> 008 </span>	  มิคลุทฺโท ปุเร อาสึ        ลุทฺโท อาสึ อสฺโต ฯ  
<span class="LineNumber"> 009 </span>	  ตสฺส เม สหาโย สุหทโย    สทฺโธ อาสิ อุปาสโก  
<span class="LineNumber"> 010 </span>	  ตสฺส กุลุปโก ภิกฺขุ         อาสิ โคตมสาวโก ฯ  
<span class="LineNumber"> 011 </span>	  โส หิ มํ อนุกมฺปนฺโต       นิวาเรสิ ปุนปฺปุนํ   
<span class="LineNumber"> 012 </span>	  มากาสิ ปาปกํ กมฺมํ        มา ตาต ทุคฺคตึ อคา  
<span class="LineNumber"> 013 </span>	  สเจ อิจฺฉสิ เปจฺจ สุขํ      วิรม ปาณวธํ อสํยมํ ฯ  
<span class="LineNumber"> 014 </span>	  ตสฺสาหํ วจนํ สุตฺวา        สุขกามสฺส หิตานุกมฺปิโน  
<span class="LineNumber"> 015 </span>	  นากาสึ สกลานุสาสนึ       จิรปาปาภิรโต อพุทฺธิมา ฯ   
<span class="LineNumber"> 016 </span>	  โส มํ ปุน ภูริสุเมธโส      อนุกมฺปาย สํยเม นิเวสยิ  
<span class="LineNumber"> 017 </span>	  สเจ ทิวา หนสิ ปาณิโน     อถ เต รตฺตึ ภวตุ สํยโม ฯ   
<span class="LineNumber"> 018 </span>	  สฺวาหํ ทิวา หนิตฺวา ปาณิโน  วิรโต รตฺตึ อโหสิ สํยโต   
<span class="LineNumber"> 019 </span>	  รตฺตาหํ ปริหาเรมิ         ทิวา ขชฺชามิ ทุคฺคโต ฯ  
<span class="LineNumber"> 020 </span>#๑ ม. โคนกตฺถเต ฯ  ๒ ยุ. วิวาสเนน ฯ  ๓ ยุ. สุริยสฺสุคฺคมนํ ฯ  ๔ ยุ. อปวิฏฺเ€ ฯ  
