<span class="LineNumber"> 001 </span>	  ตํ มํ าตี อมิตฺตาว        กึ มํ กาเมสุ ยุฺชถ  
<span class="LineNumber"> 002 </span>	  ชานาถ มํ ปพฺพชิตํ         มุณฺฑํ สงฺฆาฏิปารุตํ ฯ  
<span class="LineNumber"> 003 </span>	  อุตฺติฏฺ€ปิณฺโฑ อุฺโฉ จ      ปํสุกูลฺจ จีวรํ  
<span class="LineNumber"> 004 </span>	  เอตํ โข มม สารุปฺปํ       อนคารูปนิสฺสโย ฯ  
<span class="LineNumber"> 005 </span>	  วนฺตา มเหสีหิ ๑ กามา    เย ทิพฺพา เย จ มานุสา๓   
<span class="LineNumber"> 006 </span>	  เขมฏฺ€าเน วิมุตฺตา เต     ปตฺตา เต อจลํ สุขํ ฯ  
<span class="LineNumber"> 007 </span>	  มาหํ กาเมหิ สงฺคจฺฉึ       เยสุ ตาณํ น วิชฺชติ  
<span class="LineNumber"> 008 </span>	  อมิตฺตา วธกา กามา       อคฺคิขนฺธูปมา ทุขา ฯ  
<span class="LineNumber"> 009 </span>	  อปริสุทฺโธ ๒ เอโส สภโย  สวิฆาโต สกณฺฏโก  
<span class="LineNumber"> 010 </span>	  เคโธ สุวิสโม เจโส       มหนฺโต โมหนามุโข ฯ  
<span class="LineNumber"> 011 </span>	  อุปสคฺโค ภีมรูโป จ        กามา สปฺปสิรูปมา  
<span class="LineNumber"> 012 </span>	  เย พาลา อภินนฺทนฺติ       อนฺธภูตา ปุถุชฺชนา ฯ  
<span class="LineNumber"> 013 </span>	  กามสํสคฺคสตฺตา ๓ หิ ชนา  พหู  โลเก อวินฺทึสุ ๔  
<span class="LineNumber"> 014 </span>	  ปริยนฺตํ นาภิชานนฺติ        ชาติยา มรณสฺส จ ฯ   
<span class="LineNumber"> 015 </span>	  ทุคฺคติคมนํ มคฺคํ           มนุสฺสา กามเหตุกํ   
<span class="LineNumber"> 016 </span>	  พหุํ เว ปฏิปชฺชนฺติ         อตฺตโน โรคมาวหํ ฯ  
<span class="LineNumber"> 017 </span>	  เอวํ อมิตฺตชนนา          ตาปนา สงฺกิเลสิกา  
<span class="LineNumber"> 018 </span>	  โลกามิสา พนฺธนียา        กามา มรณพนฺธนา ฯ   
<span class="LineNumber"> 019 </span>#๑ ยุ. มเหสินา ฯ ๒ ยุ. ปริปนฺโถ ฯ  ๓ ม. ยุ. กามปงฺเกน สตฺตา ฯ   
<span class="LineNumber"> 020 </span>#๔ ม. ยุ. อวิทฺทสู ฯ  
