<span class="LineNumber"> 001 </span>	<B>ครั้งนั้น       โสดาปัตติผล  ได้มีในการประชุมครั้งแรก
<span class="LineNumber"> 002 </span>	พระผู้มีพระภาคเจ้าเสด็จพุทธดำเนินถึงกรุงราชคฤห์. 
<span class="LineNumber"> 003 </span>	พระจอมมุนีประทับ  ณ  พระเวฬุวันมหาวิหาร.  พระเจ้า
<span class="LineNumber"> 004 </span>	พิมพิสารทรงสดับข่าว     ก็เข้าเฝ้าพระผู้มีพระภาคเจ้า
<span class="LineNumber"> 005 </span>	ท้าวเธอมีบริวารมากถึง  ๑๑  นหุต  ทรงบูชาพระผู้มีพระ-
<span class="LineNumber"> 006 </span> 	ภาคเจ้า  ด้วยเทียน  ธูป  ของหอมและดอกไม้เป็นต้น.
<span class="LineNumber"> 007 </span>	พระผู้มีพระภาคเจ้าทรงแสดงอนุบุพพีกถาประกอบด้วย
<span class="LineNumber"> 008 </span>	กามาทีนพในสมาคมนั้นนั่นแล   จบเทศนาในครั้งนั้น
<span class="LineNumber"> 009 </span> 	สัตว์   ๘๔,๐๐๐  มีพระราชาเป็นประธาน  ก็ตรัสรู้ธรรม.
<span class="LineNumber"> 010 </span>       	        พระเจ้าสุทโธทนะพระพุทธบิดา ทรงสดับข่าว  ก็ 
<span class="LineNumber"> 011 </span>	ทรงส่งทูต  ๙  คน พร้อมด้วยบริวาร  ๙,๐๐๐  คน. ทูตทั้ง ๙
<span class="LineNumber"> 012 </span>	คน   พร้อมด้วยบริวาร   ๙,๐๐๐  คน   ก็บรรลุพระอรหัต
<span class="LineNumber"> 013 </span>	ทูลขอบวชกะพระมุนี.    ในที่สุด    กาฬุทายีอำมาตย์ 
<span class="LineNumber"> 014 </span>	ก็ถือเพศภิกษุ    พร้อมบริวาร  ๑,๐๐๐  คน    ท่านจึงทูล
<span class="LineNumber"> 015 </span> 	อาราธนาพระผู้มีพระภาคเจ้า.  
<span class="LineNumber"> 016 </span>         	        พระจอมศากยมุนี   ทรงรับอาราธนาแล้ว   เสด็จ
<span class="LineNumber"> 017 </span> 	เดินทางใหญ่  เสด็จพุทธดำเนินมาโดยลำดับพร้อมด้วย
<span class="LineNumber"> 018 </span> 	ภิกษุ  ๒๐,๐๐๐  รูป  ก็ลุถึงกรุงกบิลพัศดุ์.  พระองค์ทรง
<span class="LineNumber"> 019 </span> 	ทำปาฏิหาริย์   ณ  ริมฝั่งแม่น้ำโรหิณี.   พระผู้มีพระภาค
<span class="LineNumber"> 020 </span> 	เจ้า  จอมศากยมุนี  ประทับนั่งแสดงธรรมคือมหาเวส-
<span class="LineNumber"> 021 </span> 	สันดรชาดกโปรดพระพุทธบิดา   ท่ามกลางบัลลังก์นั้น.
<span class="LineNumber"> 022 </span> 	สัตว์  ๘๔,๐๐๐  ก็ได้ตรัสรู้ธรรม] </B>
