<span class="LineNumber"> 001 </span>	พึงสมาทานรักษาอุโบสถศีลโดยเคารพ   ราชเสวกนั้น 
<span class="LineNumber"> 002 </span> 	ควรอยู่ในราชสำนักได้   ราชเสวกพึงบำรุงเลี้ยงสมณะ
<span class="LineNumber"> 003 </span> 	และพราหมณ์ผู้มีศีล    เป็นพหูสูต     ด้วยข้าวและน้ำ
<span class="LineNumber"> 004 </span>	ราชเสวกนั้นควรอยู่ในราชสำนักได้   ราชเสวกผู้หวัง  
<span class="LineNumber"> 005 </span> 	ความเจริญแก่ตน     พึงเข้าไปสมาคมคบหาละสมณะ
<span class="LineNumber"> 006 </span>	และพราหมณ์ผู้มีศีล   เป็นพหูสูต   มีปัญญา. 
<span class="LineNumber"> 007 </span>	        	[๙๖๙]  ราชเสวกไม่พึงทำทาน   ที่เคยพระราช-
<span class="LineNumber"> 008 </span>	ทานในสมณพราหมณ์ให้เสื่อมไป   อนึ่ง   เห็นพวก
<span class="LineNumber"> 009 </span> 	วณิพกซึ่งมาในเวลาพระราชทานไม่ควรห้ามอะไรเลย
<span class="LineNumber"> 010 </span> 	ราชเสวกพึงมีปัญญา    สมบูรณ์ด้วยความรู้    ฉลาดใน
<span class="LineNumber"> 011 </span> 	วิธีจักราชกิจ   รู้จักกาล  รู้จักสมัย   ราชเสวยนั้นควร
<span class="LineNumber"> 012 </span> 	อยู่ในราชสำนักได้  ราชเสวกพึงเป็นคนขยันหมั่นเพียร
<span class="LineNumber"> 013 </span> 	ไม่ประมาท    มีปัญญาสอดส่องพิจารณาในการงานที่
<span class="LineNumber"> 014 </span> 	ตนพึงทำ    จัดการงานให้สำเร็จด้วยดี    ราชเสวกนั้น 
<span class="LineNumber"> 015 </span> 	ควรอยู่ในราชสำนักได้.
<span class="LineNumber"> 016 </span>         	        [๙๗๐]  อนึ่ง    ราชเสวกพึงไปตรวจตราดูลาน
<span class="LineNumber"> 017 </span>   	ข้าวสาลีปศุสัตว์และนาเสมอๆ  พึงตวงข้าวเปลือกให้รู้
<span class="LineNumber"> 018 </span> 	ประมาณแล้ว   ให้เก็บไว้ในฉาง  พึงนักบริวารชนใน
<span class="LineNumber"> 019 </span> 	เรือนแล้ว   ให้หุงต้มพอประมาณ   ไม่ควรตั้งบุตรธิดา
<span class="LineNumber"> 020 </span> 	พี่น้อง    หรือวงศ์ญาติ  ผู้ไม่ตั้งอยู่ในศีลให้เป็นใหญ่
<span class="LineNumber"> 021 </span> 	เพราะคนเหล่านั้นเป็นคนพาล ไม่จัดว่าเป็นพี่น้อง  คน
<span class="LineNumber"> 022 </span>  	เหล่านั้น   เป็นเหมือนคนที่ตายไปแล้ว   แต่เมื่อเขา   
