<span class="LineNumber"> 001 </span> 	แล้วด้วยกามราคะ    ปรารถนานางอิรันทตีนาคกัญญา
<span class="LineNumber"> 002 </span> 	ไปทูลท้าวกุเวรเวสวัณผู้เรื่องยศ   ซึ่งเป็นใหญ่แห่งหมู่
<span class="LineNumber"> 003 </span> 	ยักษ์ว่า  ภพนาคนั้นเขาเรียกชื่อว่าโภควดีนครบ้าง   วาส-
<span class="LineNumber"> 004 </span>	นครบ้าง     หิรัญญวดีนครบ้าง   เป็นเมืองที่บุญกรรม
<span class="LineNumber"> 005 </span>	นิรมิต  ล้วนแต่ทองคำ  สำเร็จแก่พระยานาคผู้บริบูรณ์
<span class="LineNumber"> 006 </span>	ด้วยโภคทรัพย์ทุกอย่าง   ป้อมและเชิงเทิน   สร้างโดย   
<span class="LineNumber"> 007 </span> 	สัณฐานคออูฐ   ล้วนแล้วด้วยแก้วแดงและแก้วลาย  ใน
<span class="LineNumber"> 008 </span>	นาคพิภพนั้น     มีปราสาทล้วนแล้วด้วยหิน    มุงด้วย
<span class="LineNumber"> 009 </span>	กระเบื้องทอง  ในนาคพิภพนั้น   มีไม้มะม่วง   ไม้
<span class="LineNumber"> 010 </span>	หมากเม่า  ไม้หว้า   ไม้ตีนเป็ด  ไม้จิก   ไม้การะเกด
<span class="LineNumber"> 011 </span>	ไม้ประยงค์   ไม้ราชพฤกษ์    ไม้มะม่วงหอม  ไม้ชะบา
<span class="LineNumber"> 012 </span>	ไม้ยางทราย  ไม้จำปา ไม้กากระทิง   มะลิซ้อน   มะลิลา
<span class="LineNumber"> 013 </span>	และไม้กะเบา  ต้นไม้ในนาคพิภพเหล่านี้มีกิ่งติดต่อกัน
<span class="LineNumber"> 014 </span>	และกัน  งามยิ่งนัก ในนาคพิภพนั้น   มีต้นอินทผาลัม
<span class="LineNumber"> 015 </span>	อันสำเร็จด้วยแก้วอินทนิล  มีดอกและผลล้วนไปด้วย
<span class="LineNumber"> 016 </span>	ทองเนืองนิตย์  ท้าววรุณนาคราชผู้มีฤทธิ์มาก  เป็นผู้
<span class="LineNumber"> 017 </span>	ผุดขึ้นเกิดอยู่ในนาคพิภพนั้น     มเหสีของพระยานาค-
<span class="LineNumber"> 018 </span>	ราชนั้น   กำลังรุ่นสาว   ทรงพระนามว่าวิมลา  มีพระ
<span class="LineNumber"> 019 </span>	รูปพระโฉมอันประกอบด้วยสิริ  งดงามดังก้อนทองคำ
<span class="LineNumber"> 020 </span>	สะโอดสะองดังหน่อเถาจิงจ้อดำ  พระถันทั้งคู่มีสัณฐาน
<span class="LineNumber"> 021 </span>	ดังผลมะพลับ  น่าดูยิ่งนัก  พระฉวีวรรณแดงดังน้ำครั่ง
<span class="LineNumber"> 022 </span>	เปรียบเหมือนดอกกรรณิการ์อันแย้มบาน     เปรียบดัง
