<span class="LineNumber"> 001 </span>	<B>เวลาเย็นอันเป็นเวลาดื่มน้ำ    ก็จักคอยดื่มน้ำ   ดังลูกเนื้อ
<span class="LineNumber"> 002 </span>	ที่กำลังกระหายน้ำ  ฉะนั้น    เป็นแน่แท้   ลูกน้อยทั้ง 
<span class="LineNumber"> 003 </span>	สองของเราผู้กำพร้ายากไร้      จะยืนคอยต้อนรับเรา
<span class="LineNumber"> 004 </span>	เหมือนหนึ่งลูกโคอ่อนคอยชะแง้หาแม่  ฉะนั้น    เป็น
<span class="LineNumber"> 005 </span> 	แน่แท้ลูกน้อยทั้งสองของเราผู้ยากไร้  คงจะยืนต้อนรับ
<span class="LineNumber"> 006 </span>	เราเสมือนหนึ่งหงส์ซึ่งตกอยู่ในเปือกตม  ฉะนั้น   เป็น
<span class="LineNumber"> 007 </span>	แน่  ลูกน้อยทั้งสองของเราผู้ยากไร้  คงจะยืนคอยต้อน 
<span class="LineNumber"> 008 </span>	รับเราอยู่ในที่ใกล้ๆ อาศรม      หนทางที่จะไปก็มีอยู่
<span class="LineNumber"> 009 </span>	ทางเดียว  ทั้งเป็นทางเดินไปได้คนเดียว    โดยข้างหนึ่ง 
<span class="LineNumber"> 010 </span>	มีสระ  อีกข้างหนึ่งมีบึง  เราไม่เห็นทางอื่นซึ่งเป็นทาง
<span class="LineNumber"> 011 </span>	ไปยังอาศรมได้    ข้าแต่พระยามฤดูราชผู้มีกำลังมากใน
<span class="LineNumber"> 012 </span>	ป่าใหญ่   ดิฉันขอนอบน้อมต่อท่านทั้งหลาย  ท่านทั้ง
<span class="LineNumber"> 013 </span>	หลายเป็นพี่น้องของดิฉันโดยธรรม  ดิฉันขออ้อนวอน
<span class="LineNumber"> 014 </span>  	ขอท่านทั้งหลายจงให้หนทางแก่ดิฉันเถิด  ดิฉันเป็น
<span class="LineNumber"> 015 </span>	ภรรยาของพระราชบุตรผู้มีสิริ  ผู้ถูกขับไล่จากสีพีรัฐ
<span class="LineNumber"> 016 </span>	ดิฉันมิได้ดูหมิ่นพระราชสวามีพระองค์นั้นเลย   เหมือน
<span class="LineNumber"> 017 </span> 	ดังนางสีดาคอยอนุวัตรตามพระรามราชสวามี   ฉะนั้น 
<span class="LineNumber"> 018 </span>  	ขอท่านทั้งหลายจงหลีกทางให้ดิฉันแล้วกลับไปพบลูก 
<span class="LineNumber"> 019 </span> 	น้อยของท่านในเวลาออกหาอาหารในเวลาเย็น    ส่วน
<span class="LineNumber"> 020 </span>	ดิฉันก็จะพึงได้กลับไปพบลูกน้อยทั้งสอง   คือพ่อชาลี
<span class="LineNumber"> 021 </span> 	และแม่กัณหาชินา  อนึ่ง  มูลมันผลไม้นี้ก็มีอยู่มากและที่
<span class="LineNumber"> 022 </span>	เป็นภักษาก็มีไม่น้อย  ดิฉันขอแบ่งให้ท่านทั้งหลายกึ่งหนึ่ง
<span class="LineNumber"> 023 </span> 	ดิฉันอ้อนวอนแล้ว  ขอท่านทั้งหลายจงให้ทางแก่ดิฉัน</B>
