<span class="LineNumber"> 001 </span>	<B>จะได้สรงสนานและเสวยในแม่น้ำนั้น  ปลุกปลอบพระ
<span class="LineNumber"> 002 </span> 	ราชโอรสและพระราชธิดาให้สำราญพระทัย    ข้าแต่
<span class="LineNumber"> 003 </span>	พระองค์ผู้ทรงพระเจริญ   ถัดนั้นไป   พระองค์จะได้
<span class="LineNumber"> 004 </span>	ทรงเห็นต้นไทรอันมีผลหวานฉ่ำ     อยู่บนยอดเขาอัน
<span class="LineNumber"> 005 </span> 	เป็นที่รื่นรมย์   มีเงาร่มเย็น   เป็นที่เบิกบานใจ   ข้าแต่  
<span class="LineNumber"> 006 </span> 	พระองค์ผู้ทรงพระเจริญ    ถัดนั้นไป   พระองค์จะได้ 
<span class="LineNumber"> 007 </span> 	ทรงเห็นภูเขาศิลาชื่อว่านาลิกบรรพต   อันเกลื่อนกล่น
<span class="LineNumber"> 008 </span> 	ไปด้วยฝูงนกนานาชนิด    เป็นที่ชุมนุมแห่งหมู่กินนร
<span class="LineNumber"> 009 </span> 	ทางทิศอิสานแห่งนาลิกบรรพตนั้น        มีสระน้ำชื่อว่า
<span class="LineNumber"> 010 </span> 	มุจลินท์   ดาดาษไปด้วยบุณฑริกบัวขาว  และดอกไม้มี
<span class="LineNumber"> 011 </span>   	กลิ่นหอมหวาน   เชิญพระองค์ผู้เป็นดังพระยาราชสีห์มี
<span class="LineNumber"> 012 </span> 	ความจำนงเหยื่อ     เสด็จเข้าไปยังไพรสณฑ์วนสถาน
<span class="LineNumber"> 013 </span> 	อันเป็นภูมิภาคเขียวชอุ่มดังเมฆอยู่เป็นนิตย์     สะพรั่งไป
<span class="LineNumber"> 014 </span> 	ด้วยไม้มีดอกและไม้มีผลทั้งสองอย่างในไพรสณฑ์นั้น 
<span class="LineNumber"> 015 </span> 	 มีฝูงวิหคมากมายต่าง ๆ สี   มีเสียงเสนาะกลมกล่อม  ต่าง
<span class="LineNumber"> 016 </span> 	ส่งเสียงประสานกันอยู่บนต้นไม้อันเผล็ดดอกตามฤดู
<span class="LineNumber"> 017 </span>    	กาล   พระองค์เสด็จถึงซอกเขาอันเป็นทางเดินลำบาก
<span class="LineNumber"> 018 </span>  	เป็นแดนเกิดแห่งแม่น้ำทั้งหลาย   จะได้ทอดพระเนตร
<span class="LineNumber"> 019 </span>  	เห็นสระโบกขรณี   อันดาดาษไปด้วยสลอดและกุ่มน้ำ
<span class="LineNumber"> 020 </span> 	มีหมู่ปลาหลากหลายเกลื่อนกล่น  มีท่าราบเรียบ   มีน้ำ
<span class="LineNumber"> 021 </span>  	มากเปี่ยมอยู่เสมอเป็นสระสี่เหลี่ยม  มีน้ำจืดดีปราศจาก
<span class="LineNumber"> 022 </span>    	กลิ่นเหม็น   พระองค์ควรทรงสร้างบรรณศาลาทางทิศ</B>
