<span class="LineNumber"> 001 </span>	<B>เดียว  หมายจะไปกรุงสาวัตถี    แต่นั้น   สามีก็ตามมา
<span class="LineNumber"> 002 </span>	ทันข้าพเจ้าในระหว่างทาง.
<span class="LineNumber"> 003 </span>	         ครั้งนั้น      ลมกัมมัชวาตเกิดขึ้นแก่ข้าพเจ้าอย่าง
<span class="LineNumber"> 004 </span>	ทารุณยิ่ง  เมฆฝนขนาดใหญ่ก็เกิดขึ้นในเวลาที่ข้าพเจ้า
<span class="LineNumber"> 005 </span>	คลอดบุตร    ขณะนั้น       สามีไปหาทัพสัมภาระเพื่อ
<span class="LineNumber"> 006 </span>	กำบังฝน  แต่ก็ถูกงูกัดตาย. 
<span class="LineNumber"> 007 </span>	        ครั้งนั้น   เพราะทุกข์ที่คลอดบุตร    ข้าพเจ้าก็เป็น
<span class="LineNumber"> 008 </span>	คนอนาถายากไร้ เห็นแม่น้ำเล็ก ๆ น้ำเต็มเปี่ยม ก็เดิน
<span class="LineNumber"> 009 </span>	ไปแม่น้ำตรงที่ตื้นเขิน  พาลูกอ่อนข้ามน้ำ  อีกคนหนึ่ง
<span class="LineNumber"> 010 </span>	เอาไว้ฝั่งโน้น   ให้ลูกอ่อนดื่มนม    เพื่อข้ามไปอีกฝั่ง
<span class="LineNumber"> 011 </span>	หนึ่ง   เหยี่ยวโฉบเฉี่ยวลูกอ่อนที่ร้องจ้าไป   ลูกอีกคน
<span class="LineNumber"> 012 </span>	หนึ่งกระแสน้ำพัดไป   ข้าพเจ้านั้นเปี่ยมด้วยความเศร้า
<span class="LineNumber"> 013 </span>	โศก.
<span class="LineNumber"> 014 </span>	        ข้าพเจ้ากลับไปกรุงสาวัตถี     ได้ยินข่าวว่าบิดา
<span class="LineNumber"> 015 </span>	มารดาพี่ชายตายเสียแล้ว    ครั้งนั้น     ข้าพเจ้าถูกความ
<span class="LineNumber"> 016 </span>	เศร้าโศกบีบคั้น เต็มเปี่ยมด้วยความเศร้าโศกใหญ่หลวง.
<span class="LineNumber"> 017 </span>	        บุตรทั้งสองก็ตาย     สามีของข้าพเจ้าก็ตายเสียที่
<span class="LineNumber"> 018 </span>	หนทาง    บิดามารดาและพี่ชายก็ถูกเผาบนเชิงตะกอน
<span class="LineNumber"> 019 </span>	เดียวกัน.
<span class="LineNumber"> 020 </span>	        ครั้งนั้น    ข้าพเจ้าผอมเหลือง  ไม่มีที่พึ่ง  มีใจห่อ
<span class="LineNumber"> 021 </span>	เหี่ยว    เดินซมซานไปพบพระผู้ทรงฝึกชนที่ควรฝึก
<span class="LineNumber"> 022 </span>	พระศาสดาได้ตรัสกะข้าพเจ้าว่า   อย่าเศร้าโศกถึงบุตร</B>
