<span class="LineNumber"> 001 </span>	           <B>แต่ก่อน   คิ้วของข้าพเจ้าสวยงามคล้ายรอยเขียน
<span class="LineNumber"> 002 </span>	ที่จิตรกรบรรจงเขียน  เดี๋ยวนี้   กลายเป็นห้อย   ย่นลง
<span class="LineNumber"> 003 </span>	เพราะชรา   พระดำรัสของพระพุทธเจ้าผู้ตรัสแต่ความ
<span class="LineNumber"> 004 </span>	จริง   เป็นคำจริงแต่   ไม่แปรเป็นอื่น. 
<span class="LineNumber"> 005 </span>	        แต่ก่อน    ดวงตาทั้งคู่ของข้าพเจ้าดำขลับมีประ-
<span class="LineNumber"> 006 </span>	กายงาม  คล้ายแหวนมณี  เดี๋ยวนี้    ถูกชราทำลายเสีย
<span class="LineNumber"> 007 </span>	แล้วจึงไม่งาม      พระดำรัสของพระพุทธเจ้าผู้ตรัสแต่
<span class="LineNumber"> 008 </span>	ความจริง  เป็นคำจริงแท้   ไม่แปรเป็นอื่น.
<span class="LineNumber"> 009 </span>	        แต่ก่อน   เมื่อวัยสาว    จมูกของข้าพเจ้าโด่งงาม
<span class="LineNumber"> 010 </span>	เหมือนเกลียวหรดาล  เดี๋ยวนี้   กลับเหี่ยวแฟบ  เพราะ
<span class="LineNumber"> 011 </span>	ชรา   พระดำรัสของพระพุทธเจ้าผู้ตรัสแต่ความจริง
<span class="LineNumber"> 012 </span>	เป็นคำจริงแท้   ไม่แปรเป็นอื่น.
<span class="LineNumber"> 013 </span>	        แต่ก่อน ใบหูทั้งสองของข้าพเจ้าสวยงามเหมือน
<span class="LineNumber"> 014 </span>	ตุ้มหูที่ช่างทำอย่างประณีตเสร็จเรียบร้อยแล้ว   เดี๋ยวนี้
<span class="LineNumber"> 015 </span>	กลายเป็นห้อยย่น     เพราะชรา    พระดำรัสของพระ-
<span class="LineNumber"> 016 </span>	พุทธเจ้าผู้ตรัสแต่ความจริง   เป็นคำจริงแท้     ไม่แปร
<span class="LineNumber"> 017 </span>	เป็นอื่น.
<span class="LineNumber"> 018 </span>	        แต่ก่อน   ฟันของข้าพเจ้าสวยงามเหมือนหน่อตูม
<span class="LineNumber"> 019 </span>	ของต้นกล้วย เดี๋ยวนี้กลับหักดำ  เพราะชรา พระดำรัส
<span class="LineNumber"> 020 </span>	ของพระพุทธเจ้าผู้ตรัสแต่ความจริง      เป็นคำจริงแท้
<span class="LineNumber"> 021 </span>	ไม่แปรเป็นอื่น.
<span class="LineNumber"> 022 </span>	        แต่ก่อน    ข้าพเจ้าพูดเสียงไพเราะเหมือนนก 
<span class="LineNumber"> 023 </span>	ดุเหว่า   ที่มีปกติเที่ยวไปในไพรสณฑ์ในป่าใหญ่   ส่ง</B>
	
