<span class="LineNumber"> 001 </span>	         <B>เมื่อถึงภพสุดท้าย   ข้าพระองค์เกิดในสกุลเศรษฐี  
<span class="LineNumber"> 002 </span>	ทรัพย์มาก   ประสบสุข    ที่จัดไว้เสร็จแล้วอย่างนั้น 
<span class="LineNumber"> 003 </span>	รุ่งโรจน์ด้วยรัตนะนานาชนิด   มั่งคั่งด้วยกามสมบัติทุก
<span class="LineNumber"> 004 </span>	อย่าง  ในกรุงสาวัตถี. 
<span class="LineNumber"> 005 </span>	       ข้าพระองค์   พรั่งพร้อมด้วยความงดงามแห่งรูป
<span class="LineNumber"> 006 </span>	ได้รับยกย่องในตระกูลทั้งหลาย    อันมหาชนสักการะ
<span class="LineNumber"> 007 </span>	บูชา  นับถือและยำเกรงแล้ว.
<span class="LineNumber"> 008 </span>	       ข้าพระองค์   ล้ำคนทั้งหลายด้วยความงามแห่ง
<span class="LineNumber"> 009 </span>	รูปและสิริ   อันบุตรเศรษฐีหลายร้อยปรารถนาอยากได้.
<span class="LineNumber"> 010 </span>	       ข้าพระองค์ละเรือนบวชไม่มีเรือนยังไม่ทันถึง
<span class="LineNumber"> 011 </span>	ครึ่งเดือน  ก็บรรลุ  สัจจะ ๔.
<span class="LineNumber"> 012 </span>	       ข้าพระองค์จักเนรมิตรถเทียมม้า  ๔  ตัว ด้วยฤทธิ์
<span class="LineNumber"> 013 </span>	มาถวายบังคมพระยุคลบาทของพระพุทธเจ้า   ผู้เป็นที่
<span class="LineNumber"> 014 </span>	พึ่งของโลก  เป็นผู้มีสิริ.
<span class="LineNumber"> 015 </span>	       ข้าพระองค์เป็นผู้ชำนาญในฤทธิ์   ในทิพโสต 
<span class="LineNumber"> 016 </span>	ข้าแต่พระมหามุนี    ข้าพระองค์ชำนาญเจโตปริยญาณ.
<span class="LineNumber"> 017 </span>	       ข้าพระองค์รู้ปุพเพนิวาสญาณ    ชำระทิพยจักษุ
<span class="LineNumber"> 018 </span>	สิ้นอาสวะทุกอย่าง  บัดนี้   ไม่มีการเกิดอีก.
<span class="LineNumber"> 019 </span>	       ญาณในอรรถ   ธรรม นิรุตติ   และปฏิภาณของ
<span class="LineNumber"> 020 </span>	ข้าพระองค์บริสุทธิ์ไร้มลทิน      เพราะอานุภาพของ
<span class="LineNumber"> 021 </span>	พระผู้ทรงแสวงคุณอันยิ่งใหญ่.
<span class="LineNumber"> 022 </span>	       ชั่วขณะ     ชนจำนวนนับพัน    ก็น้อมเอาจีวร
<span class="LineNumber"> 023 </span>	บิณฑบาต  คิลานปัจจัยและเสนาสนะ  เข้ามาโดยรอบ.</B>
