<span class="LineNumber"> 001 </span>                              <B>แต่ก่อน   คิ้วของข้าพเจ้าสวยงามคล้ายรอยเขียน
<span class="LineNumber"> 002 </span>	ที่จิตรกรบรรจงเขียนไว้  เดี่ยวนี้  กลายเป็นห้อยย่นลง
<span class="LineNumber"> 003 </span>	เพราะชรา   พระดำรัสของพระพุทธเจ้าผู้ตรัสแต่ความ
<span class="LineNumber"> 004 </span>	จริง  เป็นคำจริงแท้   ไม่แปรเป็นอื่น.  
<span class="LineNumber"> 005 </span>	       แต่ก่อน  ดวงตาทั้งคู่ของข้าพเจ้าดำขลับมีประกาย
<span class="LineNumber"> 006 </span>	งาม  คล้ายแหวนมณี   เดี๋ยวนี้   ถูกชราทำลายเสียแล้ว
<span class="LineNumber"> 007 </span>	จึงไม่งาม    พระดำรัสของพระพุทธเจ้าผู้ตรัสแต่ความ
<span class="LineNumber"> 008 </span>	จริง  เป็นคำจริงแท้  ไม่แปรเป็นอื่น.
<span class="LineNumber"> 009 </span>	       แต่ก่อน   เมื่อวัยสาว   จมูกของข้าพเจ้าโด่งงาม
<span class="LineNumber"> 010 </span>	เหมือนเกลียวหรดาล  เดี๋ยวนี้กลับเหี่ยวแฟบเพราะชรา
<span class="LineNumber"> 011 </span>	พระดำรัสของพระพุทธเจ้าผู้ตรัสแต่ความจริง  เป็นคำ
<span class="LineNumber"> 012 </span>	จริงแท้  ไม่แปรเป็นอื่น.
<span class="LineNumber"> 013 </span>	       แต่ก่อน ใบหูทั้งสองของข้าพเจ้าสวยงามเหมือน
<span class="LineNumber"> 014 </span>	ตุ้มหูที่ช่างทำอย่างประณีตเสร็จเรียบร้อยแล้ว    เดี๋ยวนี้
<span class="LineNumber"> 015 </span>	กลับห้อย  ย่นเพราะชรา    พระดำรัสของพระพุทธเจ้า
<span class="LineNumber"> 016 </span>	ผู้ตรัสแต่ความจริง  เป็นคำจริงแท้   ไม่แปรเป็นอื่น.
<span class="LineNumber"> 017 </span>	       แต่ก่อน  ฟันของข้าพเจ้าสวยงามเหมือนหน่อตูม
<span class="LineNumber"> 018 </span>	ของต้นกล้วย  เดี๋ยวนี้กลับหักดำเพราะชรา พระดำรัส
<span class="LineNumber"> 019 </span>	ของพระพุทธเจ้าผู้ตรัสแต่ความจริง      เป็นคำจริงแท้
<span class="LineNumber"> 020 </span>	ไม่แปรเป็นอื่น.
<span class="LineNumber"> 021 </span>	       แต่ก่อน   ข้าพเจ้าพูดเสียงไพเราะเหมือนนกดุเหว่า
<span class="LineNumber"> 022 </span>	ที่มีปกติเที่ยวไปในไพรสณฑ์ในป่าใหญ่   ส่งเสียงไพ-
<span class="LineNumber"> 023 </span>	เราะ   เดี๋ยวนี้   คำพูดของข้าพเจ้า   ก็พูดพลาดเพี้ยน</B>
