<span class="LineNumber"> 001 </span>	<B>เสียงร้องไพเราะ  เดี๋ยวนี้    คำพูดของข้าพเจ้า    ก็พูด
<span class="LineNumber"> 002 </span>	พลาดเพี้ยนไปในที่นั้น ๆ   เพราะชรา  พระดำรัสของ
<span class="LineNumber"> 003 </span>	พระพุทธเจ้าผู้ตรัสแต่ความจริง    เป็นคำจริงแต่    ไม่
<span class="LineNumber"> 004 </span>	แปรเป็นอื่น. 
<span class="LineNumber"> 005 </span>	       แต่ก่อน     คอของข้าพเจ้าสวยงามกลมเกลี้ยง
<span class="LineNumber"> 006 </span>	เหมือนสังข์ขัดเกลี้ยงเกลาดีแล้ว    เดี๋ยวนี้     กลายเป็น
<span class="LineNumber"> 007 </span>	งุ้มค้อมลง  เพราะชรา   พระดำรัสของพระพุทธเจ้าผู้
<span class="LineNumber"> 008 </span>	ตรัส แต่ความจริง  เป็นคำจริงแท้   ไม่แปรเป็นอื่น.
<span class="LineNumber"> 009 </span>	       แต่ก่อน      แขนทั้งสองของข้าพเจ้าสวยงาม
<span class="LineNumber"> 010 </span>	เปรียบเสมือนไม่กลอน  กลมกลึง  เดี๋ยวนี้  กลายเป็น
<span class="LineNumber"> 011 </span>	ลีบเหมือนกึ่งแคคด   เพราะชรา   พระดำรัสของพระ-
<span class="LineNumber"> 012 </span>	พุทธเจ้าตรัสแต่ความจริง  เป็นคำจริงแท้   ไม่แปรเป็น
<span class="LineNumber"> 013 </span>	อย่างอื่น.
<span class="LineNumber"> 014 </span>	       แต่ก่อน  มือทั้งสองของข้าพเจ้าสวยงาม  ประดับ
<span class="LineNumber"> 015 </span>	ด้วยแหวนทองงามระยับ     เดี๋ยวนี้    กลายเป็นเสมือน
<span class="LineNumber"> 016 </span>	เหง้ามัน   เพราะชรา  พระดำรัสของพระพุทธเจ้าผู้ตรัส
<span class="LineNumber"> 017 </span>	แต่ความจริง  เป็นคำจริงแต่  ไม่แปรเป็นอื่น.
<span class="LineNumber"> 018 </span>	       แต่ก่อน   ถันทั้งสองของข้าพเจ้าอวบอัดกลมกลึง
<span class="LineNumber"> 019 </span>	ประชิดกันและงอนสล้างสวยงาม  เดี๋ยวนี้    กลายเป็น
<span class="LineNumber"> 020 </span>	หย่อนยานเหมือนถุงหนังที่ไม่มีน้ำ   เพราะชรา   พระ-
<span class="LineNumber"> 021 </span>	ดำรัสของพระพุทธเจ้า  ตรัสแต่ความจริง  เป็นคำจริง
<span class="LineNumber"> 022 </span>	แท้  ไม่แปรเป็นอื่น.
<span class="LineNumber"> 023 </span>	       แต่ก่อน  กายของข้าพเจ้าเกลี้ยงเกลาดังแผ่นทอง
<span class="LineNumber"> 024 </span>	สวยงาม    เดี๋ยวนี้     กลายเป็นสะพรั่งด้วยเส้นเอ็นอัน</B>
