<span class="LineNumber"> 001 </span>	<B>อปฺปมาโท  อ.  ความไม่ประมาท  อมตํปทํ  เป็น
<span class="LineNumber"> 002 </span>	หนทางเครื่องดำเนินไปสู่อมตะ  (โหติ)  ย่อมเป็น
<span class="LineNumber"> 003 </span>	ปมาโท  อ.ความประมาท  ปทํ  เป็นหนทางเครื่อง
<span class="LineNumber"> 004 </span>	ดำเนินไป  มจฺจุโน  แห่งมัจจุ  (โหติ)  ย่อม  
<span class="LineNumber"> 005 </span>	เป็น  อปฺปมตฺตา  สตฺตา  อ.  สัตว์ ท.  ผู้ไม่ประมาท
<span class="LineNumber"> 006 </span>	แล้ว  น  มียนฺติ  ย่อมไม่ตาย  เย  สตฺตา  อ.
<span class="LineNumber"> 007 </span>	สัตว์  ท.  เหล่าใด  ปมตฺตา  ประมาทแล้ว (เต
<span class="LineNumber"> 008 </span>	สตฺตา)  อ.  สัตว์ ท.  เหล่านั้น  (สตฺตา)  อ.  สัตว์ ท.
<span class="LineNumber"> 009 </span>	มตา  ตายแล้ว  ยถา  ฉันใด  (โหนฺติ)  ย่อมเป็น
<span class="LineNumber"> 010 </span>	(ตถา)  ฉันนั้น  ปณฺฑิตา  อ.  บัณฑิต  ท.  ตฺวา
<span class="LineNumber"> 011 </span>	ทราบแล้ว  เอตํ  อตฺถํ  ซึ่งเนื้อความนั่น  วิเสสโต
<span class="LineNumber"> 012 </span>	โดยความแปลกกัน  (€ตฺวา)  ดำรงอยู่แล้ว
<span class="LineNumber"> 013 </span>	อปฺปมาทมฺหิ  ในความไม่ประมาท  ปโมทนฺติ
<span class="LineNumber"> 014 </span>	ย่อมบันเทิง  อปฺปมาเท  ในความไม่ประมาท
<span class="LineNumber"> 015 </span>	รตา  เป็นผู้ยินดีแล้ว  โคจเร  ในธรรมอันเป็น
<span class="LineNumber"> 016 </span>	อารมณ์  อริยานํ  ของพระอริยเจ้า ท. (โหนฺติ)
<span class="LineNumber"> 017 </span>	ย่อมเป็น  เต  ปณฺฑิตา  อ.  บัณฑิต  ท.  เหล่านั้น
<span class="LineNumber"> 018 </span>	ฌายิโน  ผู้มีความเพ่ง  สาตฺติกา  ผู้มีความเพียร
<span class="LineNumber"> 019 </span>	เป็นไปติดต่อ  ทฬฺหปรกฺกามา  ผู้มีความบากบั่น
<span class="LineNumber"> 020 </span>	อันมั่น   นิจฺจํ  เป็นนิจ  ธีรา  ผู้เป็นปราชญ์
<span class="LineNumber"> 021 </span>	ผุสนฺติ  ย่อมถูกต้อง  นิพฺพานํ  ซึ่งพระนิพพาน</B>
