<span class="LineNumber"> 001 </span>	นาหํ โกเปมิ อาชีวํ        จชมาโนปิ ชีวิตํ  
<span class="LineNumber"> 002 </span>	อาราเธมิ สกํ จิตฺตํ        วิวชฺเชมิ อเนสนํ ฯ  
<span class="LineNumber"> 003 </span>	ราคูปสํหิตํ จิตฺตํ           ยทา อุปฺปชฺชเต มม  
<span class="LineNumber"> 004 </span>	สยํว ปจฺจเวกฺขามิ         เอกโก ๑ ตํ ทเมมหํ ฯ  
<span class="LineNumber"> 005 </span>	รชฺชสิ ๒ รชนีเย จ       โทสนีเย จ ทุสฺสเส  
<span class="LineNumber"> 006 </span>	มุยฺหเส โมหนีเย จ        นิกฺขมสฺสุ วนา ตุวํ ฯ  
<span class="LineNumber"> 007 </span>	วิสุทฺธานํ อยํ วาโส        นิมฺมลานํ ตปสฺสินํ  
<span class="LineNumber"> 008 </span>	มา โข วิสุทฺธํ ทูเสสิ       นิกฺขมสฺสุ วนา ตุวํ ฯ  
<span class="LineNumber"> 009 </span>	อาคาริโก ภวิตฺวาน        ทยา ยุตฺตํ ๓ ลภิสฺสสิ  
<span class="LineNumber"> 010 </span>	อุโภปิ มา วิราเธสิ        นิกฺขมสฺสุ วนา ตุวํ ฯ  
<span class="LineNumber"> 011 </span>	ฉวาลาตํ ยถา กฏฺ€ํ        น กฺวจิ กิจฺจการกํ  
<span class="LineNumber"> 012 </span>	เนว คาเม อรฺเ วา     น หิ ตํ กฏฺ€สมฺมตํ ฯ  
<span class="LineNumber"> 013 </span>	ฉวาลาตูปโม ตฺวํสิ         น คิหิ นปิ สฺโต  
<span class="LineNumber"> 014 </span>	อุภโต มุตฺตโก อชฺช        นิกฺขมสฺสุ วนา ตุวํ ฯ  
<span class="LineNumber"> 015 </span>	สิยา นุโข ตว เอตํ        โก ปชานิ ๔ หิ เต อิทํ  
<span class="LineNumber"> 016 </span>	สีฆํ ๕ ธุรํ วหิสิ ๖ เม    โกสชฺชพหุลาย จ ฯ  
<span class="LineNumber"> 017 </span>	ชิคุจฺฉิสฺสนฺติ ตํ วิฺู        อสุจึ นาคริโก ยถา  
<span class="LineNumber"> 018 </span>	อากฑฺฒิตฺวาน อิสโย        โจทยิสฺสนฺติ ตํ สทา ฯ  
<span class="LineNumber"> 019 </span>	ตํ วิฺู ปวทิสฺสนฺติ         สมติกฺกนฺตสาสนํ  
<span class="LineNumber"> 020 </span>	สํวาสํ อลภนฺโต หิ         กถํ ชีวิหิสี ตุวํ ฯ  
<span class="LineNumber"> 021 </span>#๑ ม. ยุ. เอกคฺโค ฯ ๒ ม. รชฺชเส ฯ ๓ ม. ปุตฺตํ ฯ ๔ ม. ปชานาติ ฯ  
<span class="LineNumber"> 022 </span>#๕ ม. สทฺธาธรุํ ฯ ๖ ยุ. ปาหิสิ ฯ  
