<span class="LineNumber"> 001 </span>	อสีติโกฏึ ฉฑฺเฑตฺวา        ทาสกมฺมกเร พหู  
<span class="LineNumber"> 002 </span>	โคตมสฺส ภควโต          สาสเน ปพฺพชิสฺสสิ ฯ  
<span class="LineNumber"> 003 </span>	อาราธยิตฺวา สมฺพุทฺธํ       โคตมํ สกฺยปุงฺควํ  
<span class="LineNumber"> 004 </span>	อุปวาโณติ นาเมน         เหสฺสสิ สตฺถุสาวโก ฯ  
<span class="LineNumber"> 005 </span>	สตสหสฺเส กตํ กมฺมํ        ผลํ ทสฺเสสิ เม อิธ  
<span class="LineNumber"> 006 </span>	สุมุตฺโต สรเวโคว         กิเลเส ฌาปยึ มมํ ฯ  
<span class="LineNumber"> 007 </span>	จกฺกวตฺติสฺส สนฺตสฺส        จาตุทีปิสฺสรสฺส เม  
<span class="LineNumber"> 008 </span>	ตีณิโยชนสมนฺตา           อุสฺสิสฺสนฺติ ๑ ธชา สทา ฯ  
<span class="LineNumber"> 009 </span>	สตสหสฺเส อิโต กปฺเป      ยํ กมฺมมกรึ ตทา  
<span class="LineNumber"> 010 </span>	ทุคฺคตึ นาภิชานามิ         ธชทานสฺสิทํ ผลํ ฯ  
<span class="LineNumber"> 011 </span>	ปฏิสมฺภิทา จตสฺโส         วิโมกฺขาปิจ อฏฺ€ิเม  
<span class="LineNumber"> 012 </span>	ฉฬภิฺา สจฺฉิกตา         กตํ พุทฺธสฺส สาสนนฺติ ฯ  
<span class="LineNumber"> 013 </span>	อิตฺถํ สุทํ อายสฺมา อุปวาโณ เถโร อิมา คาถาโย  
<span class="LineNumber"> 014 </span>อภาสิตฺถาติ ฯ  
<span class="LineNumber"> 015 </span>		อุปวาณตฺเถรสฺส อปทานํ สมตฺตํ ฯ  
<span class="LineNumber"> 016 </span>	ตติยํ ตีณิสรณาคมนิยตฺเถราปทานํ (๒๓)  
<span class="LineNumber"> 017 </span>	[๒๕] นคเร จนฺทวติยา ๒       มาตุปฏฺ€านโก ๓ อหํ  
<span class="LineNumber"> 018 </span>	อนฺธา มาตาปิตา มยฺหํ      เต โปเสมิ อหํ ตทา ฯ  
<span class="LineNumber"> 019 </span>#๑ ม. อุสฺสีสนฺติ ฯ ยุ. ทสฺสิสฺสนฺติ ฯ ๒ โป. พนฺธมติยา ฯ ๓ ม. มาตุปฏฺ€าโก  
<span class="LineNumber"> 020 </span>#อหุํ ฯ ยุ. มาตุปฏฺ€ายโก อหุํ ฯ  
