<span class="LineNumber"> 001 </span>	อิตฺถํ สุทํ อายสฺมา ปฺจสีลสมาทานิโย เถโร อิมา คาถาโย  
<span class="LineNumber"> 002 </span>อภาสิตฺถาติ ฯ  
<span class="LineNumber"> 003 </span>	ปฺจสีลสมาทานิยตฺเถรสฺส อปทานํ สมตฺตํ ฯ  
<span class="LineNumber"> 004 </span>		ปฺจมํ อนฺนสํสาวกตฺเถราปทานํ (๒๕)  
<span class="LineNumber"> 005 </span>	[๒๗] สุวณฺณวณฺณํ สมฺพุทฺธํ         คจฺฉนฺตํ อนฺตราปเณ  
<span class="LineNumber"> 006 </span>	กฺจนคฺฆิยสงฺกาสํ          ทฺวตฺตึสวรลกฺขณํ ฯ  
<span class="LineNumber"> 007 </span>	สิทฺธตฺถํ โลกปชฺโชตํ        อปฺปเมยฺยํ อโนปมํ  
<span class="LineNumber"> 008 </span>	อลตฺถํ ปรมํ ปีตึ           ทิสฺวา ทนฺตํ ชุตินฺธรํ ฯ  
<span class="LineNumber"> 009 </span>	สมฺพุทฺธํ อภินาเมตฺวา       โภชยินฺตํ มหามุนึ  
<span class="LineNumber"> 010 </span>	มุนิ การุณิโก โลเก ๑     อนุโมทิ มมํ ตทา ฯ  
<span class="LineNumber"> 011 </span>	ตสฺมึ มหาการุณิเก         ปรมสฺสาสการเก  
<span class="LineNumber"> 012 </span>	พุทฺเธ จิตฺตํ ปสาเทตฺวา     กปฺปํ สคฺคมฺหิ โมทหํ ฯ  
<span class="LineNumber"> 013 </span>	จตุนวุเต อิโต กปฺเป       ยํ ทานมททึ ตทา  
<span class="LineNumber"> 014 </span>	ทุคฺคตึ นาภิชานามิ         ภิกฺขทานสฺสิทํ ผลํ ฯ  
<span class="LineNumber"> 015 </span>	ปฏิสมฺภิทา จตสฺโส         วิโมกฺขาปิจ อฏฺ€ิเม  
<span class="LineNumber"> 016 </span>	ฉฬภิฺา สจฺฉิกตา         กตํ พุทฺธสฺส สาสนนฺติ ฯ  
<span class="LineNumber"> 017 </span>	อิตฺถํ สุทํ อายสฺมา อนฺนสํสาวโก เถโร อิมา คาถาโย  
<span class="LineNumber"> 018 </span>อภาสิตฺถาติ ฯ  
<span class="LineNumber"> 019 </span>		อนฺนสํสาวกตฺเถรสฺส อปทานํ สมตฺตํ ฯ  
<span class="LineNumber"> 020 </span>#๑ ยุ. มุนิ การุณิโก นาโถ อนุโมทิ จ มํ ตทา ฯ  
