<span class="LineNumber"> 001 </span>	ธมฺมกายฺจ ทีเปนฺติ ๑     เกวลํ รตนากรํ  
<span class="LineNumber"> 002 </span>	วิโกเปตุํ น สกฺโกนฺติ       โก ทิสฺวา นปฺปสีทติ ฯ  
<span class="LineNumber"> 003 </span>	อิมาหิ ตีหิ คาถาหิ         นารโท ปุรคจฺฉิ ๒ โส  
<span class="LineNumber"> 004 </span>	ปทุมุตฺตรํ ถวิตฺวาน         สมฺพุทฺธํ อปราชิตํ ฯ  
<span class="LineNumber"> 005 </span>	เตน จิตฺตปฺปสาเทน        พุทฺธสนฺถวเนน จ  
<span class="LineNumber"> 006 </span>	กปฺปานํ สตสหสฺสํ          ทุคฺคตึ นูปปชฺชหํ ๓ ฯ  
<span class="LineNumber"> 007 </span>	อิโต ตึเส กปฺปสเต        สุมิตฺโต ๔ นาม ขตฺติโย  
<span class="LineNumber"> 008 </span>	สตฺตรตนสมฺปนฺโน          จกฺกวตฺติ มหพฺพโล ฯ  
<span class="LineNumber"> 009 </span>	ปฏิสมฺภิทา จตสฺโส         วิโมกฺขาปิจ อฏฺ€ิเม  
<span class="LineNumber"> 010 </span>	ฉฬภิฺา สจฺฉิกตา         กตํ พุทฺธสฺส สาสนนฺติ ฯ  
<span class="LineNumber"> 011 </span>	อิตฺถํ สุทํ อายสฺมา อตฺถสนฺทสฺสโก เถโร อิมา คาถาโย  
<span class="LineNumber"> 012 </span>อภาสิตฺถาติ ฯ  
<span class="LineNumber"> 013 </span>	อตฺถสนฺทสฺสกตฺเถรสฺส อปทานํ สมตฺตํ ฯ  
<span class="LineNumber"> 014 </span>	อฏฺ€มํ เอกรํสนิยตฺเถราปทานํ ๕ (๑๓๘)  
<span class="LineNumber"> 015 </span>	[๑๔๐] นารโท อิติ นาเมน ๖     เกสโว อิติ มํ วิทู  
<span class="LineNumber"> 016 </span>	กุสลากุสลํ เอสํ           อคมํ พุทฺธสนฺติกํ ฯ  
<span class="LineNumber"> 017 </span>	เมตฺตจิตฺโต การุณิโก       อตฺถทสฺสี มหามุนิ  
<span class="LineNumber"> 018 </span>	อสฺสาสยนฺโต สตฺเต โส     ธมฺมํ เทเสติ จกฺขุมา ฯ  
<span class="LineNumber"> 019 </span>#๑ ม. ทีเปนฺตํ ฯ ๒ ยุ. สรคจฺฉิ โย ฯ ม. วฺหยวจฺฉโล ฯ ๓ ยุ. นูปปชฺชถ ฯ  
<span class="LineNumber"> 020 </span>#๔ ยุ. สุขิตฺโต ฯ ๕ ยุ. เอกทํสนิย ... ฯ ๖ ม. ยุ. เม นามํ ฯ  
