<span class="LineNumber"> 001 </span>	อารุฬฺหา คามณีเยภิ        จาปหตฺเถหิ จมฺมิภิ ๑  
<span class="LineNumber"> 002 </span>	ปริวาเรสฺสนฺติมํ นิจฺจํ       รตนปี€สฺสิทํ ผลํ ฯ  
<span class="LineNumber"> 003 </span>	สฏฺ€ี เธนุสหสฺสานิ         คาวี สุปุงฺควูสภา ๒  
<span class="LineNumber"> 004 </span>	วจฺฉเก ชนยิสฺสนฺติ         รตนปี€สฺสิทํ ผลํ ฯ  
<span class="LineNumber"> 005 </span>	โสฬสิตฺถีสหสฺสานิ          สพฺพาลงฺการภูสิตา  
<span class="LineNumber"> 006 </span>	วิจิตฺตวตฺถาภรณา          อามุตฺตมณิกุณฺฑลา ฯ  
<span class="LineNumber"> 007 </span>	อาฬารมุขา ๓ หสุลา      สุสฺา ตนุมชฺฌิมา  
<span class="LineNumber"> 008 </span>	ปริวาเรสฺสนฺติมํ นิจฺจํ       รตนปี€สฺสิทํ ผลํ ฯ  
<span class="LineNumber"> 009 </span>	อฏฺ€ารเส กปฺปสเต        โคตโม นาม จกฺขุมา  
<span class="LineNumber"> 010 </span>	ตมนฺธการํ วิธํเสตฺวา ๔    พุทฺโธ โลเก ภวิสฺสติ ฯ  
<span class="LineNumber"> 011 </span>	ตสฺส ทสฺสนมาคมฺม         ปพฺพชิสฺสติกิฺจโน  
<span class="LineNumber"> 012 </span>	โตสยิตฺวาน สตฺถารํ        สาสเนภิรมิสฺสติ ฯ  
<span class="LineNumber"> 013 </span>	ตสฺส ธมฺมํ สุณิตฺวาน        กิเลเส ฌาปยิสฺสติ ๕  
<span class="LineNumber"> 014 </span>	สพฺพาสเว ปริฺาย        นิพฺพายิสฺสตินาสโว ฯ  
<span class="LineNumber"> 015 </span>	วิริยํ เม ธุรโธรยฺหํ        โยคกฺเขมาธิวาหนํ  
<span class="LineNumber"> 016 </span>	อุตฺตมตฺถํ ปฏฺ€ยาโน        สาสเน วิหรามหํ ฯ  
<span class="LineNumber"> 017 </span>	อิทํ ปจฺฉิมกํ มยฺหํ          จริโม วตฺตเต ภโว  
<span class="LineNumber"> 018 </span>	สพฺพาสวปริกฺขีโณ ๖       นตฺถิ ทานิ ปุนพฺภโว ฯ  
<span class="LineNumber"> 019 </span>	กิเลสา ฌาปิตา มยฺหํ       ภวา สพฺเพ สมูหตา  
<span class="LineNumber"> 020 </span>	นาโคว พนฺธนํ เฉตฺวา      วิหรามิ อนาสโว ฯ  
<span class="LineNumber"> 021 </span>#๑ ม. ยุ. วมฺมิภิ ฯ ๒ ม. โทหฺา ปุงฺควูสเภ ฯ ยุ. โรหฺา ปุงฺควูสภา ฯ  
<span class="LineNumber"> 022 </span>#๓ ม. ยุ. อาฬารปมฺหา ฯ ๔ ม. ยุ. วิธเมตฺวา ฯ ๕ ม. ฆาตยิสฺสติ ฯ  
<span class="LineNumber"> 023 </span>#๖ ม. สพฺพาสวา ปริกฺขีณา ฯ  
