<span class="LineNumber"> 001 </span>	นิสชฺช ตตฺถ ภควา         สุเมโธ โลกนายโก  
<span class="LineNumber"> 002 </span>	ธมฺมํ เม กถยิ พุทฺโธ       โสกสลฺลวิโนทนํ ฯ  
<span class="LineNumber"> 003 </span>	อนวฺหตา ๑ ตโต อาคา ๒ นานุฺาตา อิโต คตา  
<span class="LineNumber"> 004 </span>	ยถา คตา ตถา คตา       ตตฺถ กา ปริเทวนา ฯ  
<span class="LineNumber"> 005 </span>	ยถาปิ ปตฺติกา ๓ สตฺตา    วสฺสมานาย วุฏฺ€ิยา  
<span class="LineNumber"> 006 </span>	สภตฺเต ๔ อุปคจฺฉนฺติ      วสฺสาย ๕ ปตนาย เต ฯ  
<span class="LineNumber"> 007 </span>	วสฺเสว ๖ เต โอรมิเต    สมฺปยนฺติ ยทิจฺฉกํ  
<span class="LineNumber"> 008 </span>	เอวํ มาตา ปิตา ตุยฺหํ      ตตฺถ กา ปริเทวนา ฯ  
<span class="LineNumber"> 009 </span>	อาคนฺตุกา ปาหุนกา        จลิเตทิตกมฺปิกา ๗  
<span class="LineNumber"> 010 </span>	เอวํ มาตา ปิตา ตุยฺหํ      ตตฺถ กา ปริเทวนา ฯ  
<span class="LineNumber"> 011 </span>	ยถาปิ อุรโค ชิณฺณํ         หิตฺวา คจฺฉติ สนฺตนน ๘  
<span class="LineNumber"> 012 </span>	เอวํ มาตา ปิตา ตุยฺหํ      สนฺตนน อิธ หิยฺยเร ฯ  
<span class="LineNumber"> 013 </span>	พุทฺธสฺส คิรมฺาย         โสกสลฺลํ วิวชฺชยึ  
<span class="LineNumber"> 014 </span>	ปามุชฺชํ ชนยิตฺวาน         พุทฺธเสฏฺ€ํ อวนฺทหํ ฯ  
<span class="LineNumber"> 015 </span>	วนฺทิตฺวาน มหานาคํ        คิริมฺชริ ๙ ปูชยี  
<span class="LineNumber"> 016 </span>	ทิพฺพคนฺเธน สมฺปนฺนํ        สุเมธํ โลกนายกํ ฯ  
<span class="LineNumber"> 017 </span>	ปูชยิตฺวาน สมฺพุทฺธํ         สิเร กตฺวาน อฺชลึ  
<span class="LineNumber"> 018 </span>	อนุสฺสรํ คุณคฺคานิ          สนฺถวึ โลกนายกํ ฯ  
<span class="LineNumber"> 019 </span>	วิติณฺโณสิ ๑๐ มหาวีร      สพฺพฺู โลกนายโก  
<span class="LineNumber"> 020 </span>	สพฺเพ สตฺเต อุทฺธเรสิ      าเณน ตฺวํ มหามุเน ฯ  
<span class="LineNumber"> 021 </span>#๑ ม. อนวฺหิตา ฯ ๒ ม. ยุ. อาคุํ ฯ ๓ ม. ยุ. ปถิกา ฯ ๔ ม. ยุ. สภณฺฑา ฯ  
<span class="LineNumber"> 022 </span>#๕ ม. ยุ. วสฺสสฺสาปตนาย ... ฯ ๖ ยุ. วสฺเส เอเต ฯ ๗ ม. ยุ. จลิเตริตกมฺปิตา ฯ  
<span class="LineNumber"> 023 </span>#๘ ม. สํ ตจํ ... ฯ ๙ ยุ. คิรปฺชลึ ฯ ๑๐ ม. ยุ. นิตฺติณฺโณสิ ฯ  
