<span class="LineNumber"> 001 </span>	กิเลสา ฌาปิตา มยฺหํ       ภวา สพฺเพ สมูหตา  
<span class="LineNumber"> 002 </span>	นาโคว พนฺธนํ เฉตฺวา      วิหรามิ อนาสโว ฯ  
<span class="LineNumber"> 003 </span>	สฺวาคตํ วต เม อาสิ       มม พุทฺธสฺส สนฺติเก  
<span class="LineNumber"> 004 </span>	ติสฺโส วิชฺชา อนุปฺปตฺตา     กตํ พุทฺธสฺส สาสนํ ฯ  
<span class="LineNumber"> 005 </span>	ปฏิสมฺภิทา จตสฺโส         วิโมกฺขาปิจ อฏฺ€ิเม  
<span class="LineNumber"> 006 </span>	ฉฬภิฺา สจฺฉิกตา         กตํ พุทฺธสฺส สาสนนฺติ ฯ  
<span class="LineNumber"> 007 </span>	อิตฺถํ สุทํ อายสฺมา สลฬมณฺฑปิโย เถโร อิมา คาถาโย  
<span class="LineNumber"> 008 </span>อภาสิตฺถาติ ฯ  
<span class="LineNumber"> 009 </span>		สลฬมณฺฑปิยตฺเถรสฺส อปทานํ สมตฺตํ ฯ  
<span class="LineNumber"> 010 </span>		นวมํ สพฺพทายกตฺเถราปทานํ (๓๙๙)  
<span class="LineNumber"> 011 </span>	[๔๐๑] มหาสมุทฺทโมคฺคยฺห         ภวนํ เม สุนิมฺมิตํ  
<span class="LineNumber"> 012 </span>	สุนิมฺมิตา โปกฺขรณี         จกฺกวากุปกุชฺชิตา ๑ ฯ  
<span class="LineNumber"> 013 </span>	มนฺทาลเกหิ สฺฉนฺนา       ปทุมุปฺปลเกหิ จ  
<span class="LineNumber"> 014 </span>	นที จ สนฺทเต ตตฺถ        สุปติตฺถา มโนรมา ฯ  
<span class="LineNumber"> 015 </span>	มจฺฉกจฺฉปสฺฉนฺนา         นานามิคสโมตฺถฏา ๒  
<span class="LineNumber"> 016 </span>	มยูรโกฺจาภิรุทา          โกกิลาทีหิ วคฺคุหิ ฯ  
<span class="LineNumber"> 017 </span>	ปาเรวตา รวิหํสา         จกฺกวากา นทีจรา  
<span class="LineNumber"> 018 </span>	ทินฺทิภา สาลิกา เจตฺถ      จปฺปกา ๓ ชีวชีวกา ฯ  
<span class="LineNumber"> 019 </span>#๑ ม. ยุ. จกฺกวากปกุชฺชิตา ฯ ๒ ม. นานาทิชสโมตฺถฏา ฯ ๓ ม. ปมฺมกา ฯ  
<span class="LineNumber"> 020 </span>#ยุ. ปมฺปกา ฯ  
