<span class="LineNumber"> 001 </span>  	 <B>ได้เข้ารักษาอุโบสถอยู่วันหนึ่งคืนหนึ่ง    นิมนต์พระ-  
<span class="LineNumber"> 002 </span>	คุณเจ้าดูวิมานของดีฉันนั้นเถิด  ยิ่งกว่านั้น   ดิฉันยัง
<span class="LineNumber"> 003 </span>  	เป็นนางฟ้าที่มีรูปร่างและผิวพรรณน่ารัก    ทั้งยังเป็น
<span class="LineNumber"> 004 </span>	ผู้เลิศกว่านางอัปสรตั้งพันนางอีกด้วย  นิมนต์พระคุณ
<span class="LineNumber"> 005 </span>  	เจ้าดูผลแห่งบุญทั้งหลายเถิด      เพราะบุญกรรมนั้น
<span class="LineNumber"> 006 </span>	ดีฉันจึงมีวรรณะงามเช่นนี้ ฯ ล ฯ และมีรัศมีสว่างไสว
<span class="LineNumber"> 007 </span> 	ไปทั่วทุกทิศ  เพราะบุญกรรมนั้น.</B>
<span class="LineNumber"> 008 </span>         (๒)      พระมหาโมคคัลลานเถระถามว่า 
<span class="LineNumber"> 009 </span>          	        <B>ดูก่อนแม่เทพธิดา  ท่านมีวรรณะงามยิ่งนัก  มี 
<span class="LineNumber"> 010 </span>	รัศมีส่องสว่างไสวไปทั่วทุกทิศ    สถิตอยู่เหมือนดาว
<span class="LineNumber"> 011 </span>   	ประกายพรึก   เพราะบุญกรรมอะไร   ท่านจึงมีวรรณะ
<span class="LineNumber"> 012 </span>	งามเช่นนี้   ฯ ล ฯ    และมีรัศมีสว่างไสวไปทั่วทุกทิศ
<span class="LineNumber"> 013 </span>    	เพราะบุญกรรมอะไร.</B>
<span class="LineNumber"> 014 </span>          	        <B>นางเทพธิดานั้น  อันพระโมคคัลลานเถระถาม
<span class="LineNumber"> 015 </span>	แล้ว   มีความปลาบปลื้มใจ    ได้พยากรณ์ปัญหาแห่ง
<span class="LineNumber"> 016 </span>  	ผลกรรมที่ถูกถามว่า</B>
<span class="LineNumber"> 017 </span>          	         <B>ดีฉันยืนอยู่ในน้ำ   มีจิตเลื่อมใส    ได้ถวายน้ำ
<span class="LineNumber"> 018 </span>	ใช้และน้ำฉันแก่ภิกษุรูปหนึ่ง     นิมนต์พระคุณเจ้าดู   
<span class="LineNumber"> 019 </span>  	วิมานของดีฉันนั้นเถิด     ยิ่งกว่านั้น     ดีฉันยังเป็น
<span class="LineNumber"> 020 </span>	นางฟ้าที่มีรูปร่างและผิวพรรณน่ารัก  ทั้งยังเป็นผู้เลิศ
<span class="LineNumber"> 021 </span>   	กว่านางอัปสรตั้งพันนางอีกด้วย  นิมนต์พระคุณเจ้าดู</B>
