<span class="LineNumber"> 001 </span>	<B>ดวงอาทิตย์ในสารทกาล   กำลังอุทัยขึ้นมา  ดอกไม้  
<span class="LineNumber"> 002 </span>	และเครื่องประดับที่แขนทั้งสอง    ไหวพริ้วเพราะแรง
<span class="LineNumber"> 003 </span> 	ลม   ก็เปล่งเสียงกังวานไพเราะเพราะจับใจ  อันวิญญู 
<span class="LineNumber"> 004 </span>	ชนทุกคนพึงฟัง  ดูราท่านจอมเทพ  รถ   ช้าง  (ม้า )
<span class="LineNumber"> 005 </span> 	และดนตรีทั้งหลายที่อยู่สองข้างพื้นอุทยาน  ส่งเสียง 
<span class="LineNumber"> 006 </span>	ทำให้ท่านบันเทิงใจ  ดุจพิณทั้งหลายมีรางและคันถือ
<span class="LineNumber"> 007 </span>	ที่ปรับไว้เรียบร้อย  อันนักดีดพิณบรรเลงอยู่  ย่อมทำ
<span class="LineNumber"> 008 </span>	ชนผู้ฟังให้บันเทิงฉะนั้น   เมื่อพิณเป็นอันมากเหล่านี้
<span class="LineNumber"> 009 </span>	มีเสียงไพเราะเจริญใจ  อันอัปสรทั้งหลายบรรเลงอยู่
<span class="LineNumber"> 010 </span>	สนิทสนมกลมกลืนซาบซึ้งตรึงใจ    เหล่าเทพกัญญา
<span class="LineNumber"> 011 </span>	ผู้ชำนาญศิลป์     พากันฟ้อนรำขับร้องอยู่ในดอกปทุม
<span class="LineNumber"> 012 </span> 	ทั้งหลาย       เมื่อใดการขับร้องการประโคมและการ
<span class="LineNumber"> 013 </span>	ฟ้อนรำเหล่านี้  ผสมผสานเป็นอันเดียวกัน    เมื่อนั้น 
<span class="LineNumber"> 014 </span>	อัปสรพวกหนึ่งก็ฟ้อนรำอยู่ในรถของท่านนี้.</B>
<span class="LineNumber"> 015 </span>	              <B>อีกพวกหนึ่งซึ่งเป็นเทพกัญญาชั้นสูง   ก็ส่อง
<span class="LineNumber"> 016 </span>	รัศมีอยู่สองข้างในรถของท่านนั้น    ท่านอันหมู่ดนตรี 
<span class="LineNumber"> 017 </span>	ปลุกให้ตื่น  บันเทิงใจ   อันทวยเทพทั้งหลายบูชาอยู่
<span class="LineNumber"> 018 </span>	ดุจท้าวสักกะผู้ทรงวชิราวุธ  เมื่อพิณเป็นอันมากเหล่า
<span class="LineNumber"> 019 </span>	นี้มีเสียงไพเราะเจริญใจ   ซาบซึ้งตรึงใจ    อันอัปสร
<span class="LineNumber"> 020 </span>   	บรรเลงอยู่    เมื่อก่อนท่านทำกรรมอะไรไว้ด้วยตนเอง
<span class="LineNumber"> 021 </span>	ครั้งเกิดเป็นมนุษย์ในชาติก่อน   ท่านได้รักษาอุโบสถ
<span class="LineNumber"> 022 </span>	หรือว่าได้ชอบใจการประพฤติธรรม  และการสมาทาน</B>
