<span class="LineNumber"> 001 </span>	๑๒.  <B>ไม่แลดูบาตรของภิกษุสามเณรด้วยคิดจะตำหนิว่ามูมมาม</B> 
<span class="LineNumber"> 002 </span>	     แต่ถ้าแลดูด้วยคิดจะให้ของฉันที่เขายังไม่มี  ไม่ห้าม.
<span class="LineNumber"> 003 </span>	๑๓.  <B>ไม่ทำคำข้าวให้ใหญ่ขนาดคับปากเคี้ยวไม่สะดวก</B>  แม้ของ
<span class="LineNumber"> 004 </span>	     อื่นนอกจากข้าว  ถ้าทำเป็นคำใหญ่ดูเป็นเสียกิริยา  ก็ไม่ควรทำ.
<span class="LineNumber"> 005 </span>	๑๔.  <B>ต้องทำคำข้าวให้กลมกล่อม</B>  เช่น  ข้าวเหนียวหรือข้าวเจ้าที่
<span class="LineNumber"> 006 </span>	     หุงเปียก   แม้ของเคี้ยวของฉันทุกอย่าง  ควรทำให้เป็นคำ ๆ
<span class="LineNumber"> 007 </span>	     เรียบร้อย  เช่น  ขนมจีนต้องตัดให้เป็นคำ.
<span class="LineNumber"> 008 </span>	๑๕.  <B>ไม่อ้าปากรอรับคำข้าว</B>  คือ  ไม่อ้าปากเคี้ยวอาหาร  อ้า
<span class="LineNumber"> 009 </span>	     เฉพาะรับเท่านั้น.
<span class="LineNumber"> 010 </span>	๑๖.  <B>ไม่เอามือสอดเข้าปากเวลาฉัน</B>  เพราะดูสกปรก  (ถ้า
<span class="LineNumber"> 011 </span>	     ก้างติดเหงือก  ติดคอ  ต้องคายอาหาร  บ้วนปากเสียก่อน
<span class="LineNumber"> 012 </span>	     จึงสอดมือล้วงออก).
<span class="LineNumber"> 013 </span>	๑๗.  <B>ไม่พูดขณะที่คำข้าวอยู่ในปาก</B>  ต้องกลืนหรือคายแล้วจึงพูด.
<span class="LineNumber"> 014 </span>	๑๘.  <B>ไม่ฉันเดาะคำข้าว</B>  คือ  ไม่โยนคำข้าวอ้าปากรับ  เพราะเป็น
<span class="LineNumber"> 015 </span>	     กิริยาซุกซน.
<span class="LineNumber"> 016 </span>	๑๙.  <B>ไม่ฉันกัดคำข้าว</B>  ของอื่นท่านไม่ห้าม,  แต่ถ้าดูมูมมามน่า
<span class="LineNumber"> 017 </span>	     เกลียด  ก็ไม่ควรกัด.
<span class="LineNumber"> 018 </span>	๒๐.  <B>ไม่ฉันทำกระพุ้งแก้มให้ตุ่ย</B>  ต้องฉันคำเล็ก ๆ  จึงจะไม่ตุ่ย.
<span class="LineNumber"> 019 </span>	๒๑.  <B>ไม่ฉันสลัดมือ</B>  ถ้าเปรอะเปื้อนก็เช็ดหรือล้างให้สะอาด.
<span class="LineNumber"> 020 </span>	๒๒.  <B>ไม่ฉันทำเมล็ดข้าวอันเหลือจากที่เข้าปากให้ตกลงในบาตร-
<span class="LineNumber"> 021 </span>	     จาน</B>  หรือในที่นั้น ๆ.
