<span class="LineNumber"> 001 </span>	[๑๓๐] กุศลธรรมจักเกิดขึ้นแก่สัตว์ใด อกุศลธรรมจักเกิดขึ้นแก่สัตว์นั้นหรือ?
<span class="LineNumber"> 002 </span>	สัตว์เหล่าใดจักได้เฉพาะซึ่งอรหัตมรรค ในลำดับแห่งจิตใด กุศลธรรมจักเกิดขึ้นแก่สัตว์
<span class="LineNumber"> 003 </span>เหล่านั้น แต่อกุศลธรรมจักเกิดขึ้นแก่สัตว์เหล่านั้นก็หาไม่ กุศลธรรมจักเกิดขึ้น และอกุศลธรรม
<span class="LineNumber"> 004 </span>จักเกิดขึ้นแก่สัตว์เหล่านั้น นอกนี้
<span class="LineNumber"> 005 </span>	หรือว่า  อกุศลธรรมจักเกิดขึ้นแก่สัตว์ใด กุศลธรรมจักเกิดขึ้นแก่สัตว์นั้น?
<span class="LineNumber"> 006 </span>	ถูกแล้ว
<span class="LineNumber"> 007 </span>	[๑๓๑] กุศลธรรมจักเกิดขึ้นแก่สัตว์ใด อัพยากตธรรมเกิดขึ้นแก่สัตว์นั้นหรือ?
<span class="LineNumber"> 008 </span>	ถูกแล้ว
<span class="LineNumber"> 009 </span>	หรือว่า อัพยากตธรรมจักเกิดขึ้นแก่สัตว์ใด กุศลธรรมจักเกิดขึ้นแก่สัตว์นั้น?
<span class="LineNumber"> 010 </span>	อัพยากตธรรมจักเกิดขึ้นแก่สัตว์เหล่านั้น ผู้มีความพร้อมเพรียงด้วยอรหัตมรรค ผู้เป็น
<span class="LineNumber"> 011 </span>พระอรหันต์ แต่กุศลธรรมจักเกิดขึ้นแก่สัตว์เหล่านั้นก็หาไม่อัพยากตธรรม และอกุศลธรรม 
<span class="LineNumber"> 012 </span>ก็จักเกิดขึ้นแก่สัตว์เหล่านั้น นอกนี้
<span class="LineNumber"> 013 </span>	[๑๓๒] อกุศลธรรมจักเกิดขึ้นแก่สัตว์ใด อัพยากตธรรมจักเกิดขึ้นแก่สัตว์นั้นหรือ?
<span class="LineNumber"> 014 </span>	ถูกแล้ว
<span class="LineNumber"> 015 </span>	หรือว่า อัพยากตธรรมจักเกิดขึ้นแก่สัตว์ใด อกุศลธรรมจักเกิดขึ้นแก่สัตว์นั้น?
<span class="LineNumber"> 016 </span>	อัพยากตธรรมจักเกิดขึ้นแก่สัตว์เหล่านั้น คือผู้มีความพร้อมเพรียงด้วยอรหัตมรรค ผู้เป็น
<span class="LineNumber"> 017 </span>พระอรหันต์ ผู้จักได้เฉพาะซึ่งอรหัตมรรค ในลำดับแห่งจิตแต่อกุศลธรรมจักเกิดขึ้นแก่สัตว์
<span class="LineNumber"> 018 </span>เหล่านั้นก็หาไม่ อัพยากตธรรมจักเกิดขึ้น อัมยากตธรรมจักเกิดขึ้น และอกุศลธรรมก็จักเกิดขึ้น
<span class="LineNumber"> 019 </span>แก่สัตว์เหล่านั้น นอกนี้
<span class="LineNumber"> 020 </span>	[๑๓๓] กุศลธรรมจักเกิดขึ้นในภูมิใด อกุศลธรรมจักเกิดขึ้นในภูมินั้นหรือ?
<span class="LineNumber"> 021 </span>	ถูกแล้ว
<span class="LineNumber"> 022 </span>	หรือว่า อกุศลธรรมจักเกิดขึ้นในภูมิใด กุศลธรรมจักเกิดขึ้นในภูมินั้น?
<span class="LineNumber"> 023 </span>	ถูกแล้ว
<span class="LineNumber"> 024 </span>	[๑๓๔] กุศลธรรมจักเกิดขึ้นในภูมิใด อัพยากตธรรมจักเกิดขึ้นในภูมินั้นหรือ?
<span class="LineNumber"> 025 </span>	ถูกแล้ว
<span class="LineNumber"> 026 </span>	หรือว่า อัพยากตธรรมจักเกิดขึ้นในภูมิใด กุศลธรรมจักเกิดขึ้นในภูมินั้น?
