<span class="LineNumber"> 001 </span>	โสตใด เรียกว่าอินทรีย์ โสตนั้นเรียกว่าโสตด้วย เรียกว่าอินทรีย์ด้วยโสตที่เหลือ
<span class="LineNumber"> 002 </span>ไม่เรียกว่าอินทรีย์
<span class="LineNumber"> 003 </span>	อินทรีย์ เรียกว่าโสตินทรีย์หรือ
<span class="LineNumber"> 004 </span>	โสตินทรีย์ เรียกว่าอินทรีย์ด้วย เรียกว่าโสตินทรีย์ด้วย อินทรีย์ที่เหลือเรียกว่าอินทรีย์ 
<span class="LineNumber"> 005 </span>ไม่เรียกว่าโสตินทรีย์
<span class="LineNumber"> 006 </span>	ฆานะ เรียกว่าอินทรีย์หรือ
<span class="LineNumber"> 007 </span>	ถูกแล้ว
<span class="LineNumber"> 008 </span>	อินทรีย์ เรียกว่าฆานินทรีย์หรือ
<span class="LineNumber"> 009 </span>	ฆานินทรีย์ เรียกว่าอินทรีย์ด้วย เรียกว่าฆานินทรีย์ด้วย อินทรีย์ที่เหลือเรียกว่า
<span class="LineNumber"> 010 </span>อินทรีย์ ไม่เรียกว่าฆานินทรีย์
<span class="LineNumber"> 011 </span>	ชิวหา เรียกว่าอินทรีย์หรือ
<span class="LineNumber"> 012 </span>	ถูกแล้ว
<span class="LineNumber"> 013 </span>	อินทรีย์ เรียกว่าชิวหินทรีย์หรือ
<span class="LineNumber"> 014 </span>	ชิวหินทรีย์ เรียกว่าอินทรีย์ด้วย เรียกว่าชิวหินทรีย์ด้วย อินทรีย์ที่เหลือเรียกว่า
<span class="LineNumber"> 015 </span>อินทรีย์ ไม่เรียกว่าชิวหินทรีย์
<span class="LineNumber"> 016 </span>	กาย เรียกว่าอินทรีย์หรือ
<span class="LineNumber"> 017 </span>	กายใด เรียกว่าอินทรีย์ กายนั้น เรียกว่ากายด้วย เรียกว่าอินทรีย์ด้วยกายที่เหลือ
<span class="LineNumber"> 018 </span>เรียกว่ากาย ไม่เรียกว่าอินทรีย์
<span class="LineNumber"> 019 </span>	อินทรีย์ เรียกว่ากายินทรีย์หรือ
<span class="LineNumber"> 020 </span>	กายินทรีย์ เรียกว่าอินทรีย์ด้วย เรียกว่ากายินทรีย์ด้วย อินทรีย์ที่เหลือเรียกว่า
<span class="LineNumber"> 021 </span>อินทรีย์ ไม่เรียกว่ากายินทรีย์
<span class="LineNumber"> 022 </span>	ใจ เรียกว่าอินทรีย์หรือ
<span class="LineNumber"> 023 </span>	ถูกแล้ว
<span class="LineNumber"> 024 </span>	อินทรีย์ เรียกว่ามนินทรีย์หรือ
<span class="LineNumber"> 025 </span>	มนินทรีย์ เรียกว่าอินทรีย์ด้วย เรียกว่ามนินทรีย์ด้วย อินทรีย์ที่เหลือเรียกว่าอินทรีย์ 
<span class="LineNumber"> 026 </span>ไม่เรียกว่ามนินทรีย์
