<span class="LineNumber"> 001 </span>	อัญญะ เรียกว่าอินทรีย์หรือ อินทรีย์ เรียกว่าจักขุนทรีย์หรือ ฯลฯอินทรีย์ เรียกว่า
<span class="LineNumber"> 002 </span>อัญญาตาวินทรีย์หรือ
<span class="LineNumber"> 003 </span>	อัญญาตาวี เรียกว่าอินทรีย์หรือ อินทรีย์ เรียกว่าจักขุนทรีย์หรือ ฯลฯอินทรีย์ 
<span class="LineNumber"> 004 </span>เรียกว่าอัญญินทรีย์หรือ
<span class="LineNumber"> 005 </span>	[๓๘๗] ไม่ใช่จักขุ ไม่เรียกว่าอินทรีย์หรือ ไม่ใช่อินทรีย์ ไม่เรียกว่าโสตินทรีย์หรือ
<span class="LineNumber"> 006 </span>	ไม่ใช่จักขุ ไม่เรียกว่าอินทรีย์หรือ ไม่ใช่อินทรีย์ ไม่เรียกว่าฆานินทรีย์หรือ
<span class="LineNumber"> 007 </span>	ไม่ใช่จักขุ ไม่เรียกว่าอินทรีย์หรือ ไม่ใช่อินทรีย์ ไม่เรียกว่าชิวหินทรีย์หรือ
<span class="LineNumber"> 008 </span>	ไม่ใช่จักขุ ไม่เรียกว่าอินทรีย์หรือ ไม่ใช่อินทรีย์ ไม่เรียกว่ากายินทรีย์หรือ
<span class="LineNumber"> 009 </span>	ไม่ใช่จักขุ ไม่เรียกว่าอินทรีย์หรือ ไม่ใช่อินทรีย์ ไม่เรียกว่ามนินทรีย์หรือ
<span class="LineNumber"> 010 </span>	ไม่ใช่จักขุ ไม่เรียกว่าอินทรีย์หรือ ไม่ใช่อินทรีย์ ไม่เรียกว่าอิตถินทรีย์หรือ
<span class="LineNumber"> 011 </span>	ไม่ใช่จักขุ ไม่เรียกว่าอินทรีย์หรือ ไม่ใช่อินทรีย์ ไม่เรียกว่าปุริสินทรีย์หรือ
<span class="LineNumber"> 012 </span>	ไม่ใช่จักขุ ไม่เรียกว่าอินทรีย์หรือ ไม่ใช่อินทรีย์ ไม่เรียกว่าชีวิตินทรีย์หรือ
<span class="LineNumber"> 013 </span>	ไม่ใช่จักขุ ไม่เรียกว่าอินทรีย์หรือ ไม่ใช่อินทรีย์ ไม่เรียกว่าสุขินทรีย์หรือ	
<span class="LineNumber"> 014 </span>	ไม่ใช่จักขุ ไม่เรียกว่าอินทรีย์หรือ ไม่ใช่อินทรีย์ ไม่เรียกว่าทุกขินทรีย์หรือ
<span class="LineNumber"> 015 </span>	ไม่ใช่จักขุ ไม่เรียกว่าอินทรีย์หรือ ไม่ใช่อินทรีย์ ไม่เรียกว่าโสมนัสสินทรีย์หรือ
<span class="LineNumber"> 016 </span>	ไม่ใช่จักขุ ไม่เรียกว่าอินทรีย์หรือ ไม่ใช่อินทรีย์ ไม่เรียกว่าโทมนัสสินทรีย์หรือ
<span class="LineNumber"> 017 </span>	ไม่ใช่จักขุ ไม่เรียกว่าอินทรีย์หรือ ไม่ใช่อินทรีย์ ไม่เรียกว่าอุเปกขินทรีย์หรือ
<span class="LineNumber"> 018 </span>	ไม่ใช่จักขุ ไม่เรียกว่าอินทรีย์หรือ ไม่ใช่อินทรีย์ ไม่เรียกว่าสัทธินทรีย์หรือ
<span class="LineNumber"> 019 </span>	ไม่ใช่จักขุ ไม่เรียกว่าอินทรีย์หรือ ไม่ใช่อินทรีย์ ไม่เรียกว่าวิริยินทรีย์หรือ
<span class="LineNumber"> 020 </span>	ไม่ใช่จักขุ ไม่เรียกว่าอินทรีย์หรือ ไม่ใช่อินทรีย์ ไม่เรียกว่าสตินทรีย์หรือ
<span class="LineNumber"> 021 </span>	ไม่ใช่จักขุ ไม่เรียกว่าอินทรีย์หรือ ไม่ใช่อินทรีย์ ไม่เรียกว่าสมาธินทรีย์หรือ
<span class="LineNumber"> 022 </span>	ไม่ใช่จักขุ ไม่เรียกว่าอินทรีย์หรือ ไม่ใช่อินทรีย์ ไม่เรียกว่าปัญญินทรีย์หรือ
<span class="LineNumber"> 023 </span>	ไม่ใช่จักขุ ไม่เรียกว่าอินทรีย์หรือ ไม่ใช่อินทรีย์ ไม่เรียกว่าอนัญญาตัญญัสสามีตินทรีย์
<span class="LineNumber"> 024 </span>หรือ
<span class="LineNumber"> 025 </span>	ไม่ใช่จักขุ ไม่เรียกว่าอินทรีย์หรือ ไม่ใช่อินทรีย์ ไม่เรียกว่าอัญญินทรีย์หรือ
<span class="LineNumber"> 026 </span>	ไม่ใช่จักขุ ไม่เรียกว่าอินทรีย์หรือ ไม่ใช่อินทรีย์ ไม่เรียกว่าอัญญาตาวินทรีย์หรือ
