<span class="LineNumber"> 001 </span>	ถูกแล้ว
<span class="LineNumber"> 002 </span>	[๗๔๙] โสมนัสสินทรีย์เคยเกิดขึ้นแล้วในภูมิใด สัทธินทรีย์ฯลฯ ปัญญินทรีย์ 
<span class="LineNumber"> 003 </span>มนินทรีย์ เคยเกิดขึ้นแล้วในภูมินั้นหรือ
<span class="LineNumber"> 004 </span>	ถูกแล้ว
<span class="LineNumber"> 005 </span>	หรือว่า มนินทรีย์เคยเกิดขึ้นแล้วในภูมิใด โสมนัสสินทรีย์เคยเกิดขึ้นแล้วใน
<span class="LineNumber"> 006 </span>ภูมินั้น
<span class="LineNumber"> 007 </span>	ถูกแล้ว
<span class="LineNumber"> 008 </span>	[๗๕๐] อุเปกขินทรีย์เคยเกิดขึ้นแล้วในภูมิใด สัทธินทรีย์ฯลฯ ปัญญินทรีย์ 
<span class="LineNumber"> 009 </span>มนินทรีย์เคยเกิดขึ้นแล้วในภูมินั้นหรือ
<span class="LineNumber"> 010 </span>	ถูกแล้ว
<span class="LineNumber"> 011 </span>	หรือว่า มนินทรีย์เคยเกิดขึ้นแล้วในภูมิใด อุเปกขินทรีย์เคยเกิดขึ้นแล้วในภูมิ
<span class="LineNumber"> 012 </span>นั้น
<span class="LineNumber"> 013 </span>	ถูกแล้ว
<span class="LineNumber"> 014 </span>	[๗๕๑] สัทธินทรีย์เคยเกิดขึ้นแล้วในภูมิใด ปัญญินทรีย์ฯลฯ มนินทรีย์เคย
<span class="LineNumber"> 015 </span>เกิดขึ้นแล้วในภูมินั้นหรือ
<span class="LineNumber"> 016 </span>	ถูกแล้ว
<span class="LineNumber"> 017 </span>	หรือว่า มนินทรีย์เคยเกิดขึ้นแล้วในภูมิใด สัทธินทรีย์เคยเกิดขึ้นแล้วในภูมินั้น
<span class="LineNumber"> 018 </span>	ถูกแล้ว
<span class="LineNumber"> 019 </span>	[๗๕๒] ปัญญินทรีย์เคยเกิดขึ้นแล้วในภูมิใด มนินทรีย์เคยเกิดขึ้นแล้วใน
<span class="LineNumber"> 020 </span>ภูมินั้นหรือ
<span class="LineNumber"> 021 </span>	ถูกแล้ว
<span class="LineNumber"> 022 </span>	หรือว่า มนินทรีย์เคยเกิดขึ้นแล้วในภูมิใด ปัญญินทรีย์เคยเกิดขึ้นแล้วในภูมิ
<span class="LineNumber"> 023 </span>นั้น
<span class="LineNumber"> 024 </span>	ถูกแล้ว
<span class="LineNumber"> 025 </span>	[๗๕๓] จักขุนทรีย์เคยเกิดขึ้นแล้วแก่สัตว์ใด ในภูมิใดโสตินทรีย์เคยเกิดขึ้นแล้ว
<span class="LineNumber"> 026 </span>แก่สัตว์นั้น ในภูมินั้นหรือ
<span class="LineNumber"> 027 </span>	ถูกแล้ว
