<span class="LineNumber"> 001 </span>	๕.  ปาจิตตีย์  ๙๒  สิกขาบท  ชื่อปาจิตติยกัณฑ์.
<span class="LineNumber"> 002 </span>	๖.  ปาฏิเทสนียะ  ๔  สิกขาบท  ชื่อปาฏิเทสนียกัณฑ์.
<span class="LineNumber"> 003 </span>	๗.  เสขิยวัตร  ๗๕  สิกขาบท   ชื่อเสขิยกัณฑ์.
<span class="LineNumber"> 004 </span>	๘.  อธิกรณสมถะ  ๗  สิกขาบท  ชื่ออธิกรณสมถกัณฑ์.
<span class="LineNumber"> 005 </span>	รวมภิกขุวิภังค์มี  ๒๒๗  สิกขาบท  เป็นวินัยของภิกษุ.
<span class="LineNumber"> 006 </span>                               <B>ภิกขุนีวิภังค์มี  ๗  กัณฑ์</B>
<span class="LineNumber"> 007 </span>	๑.  ปาราชิก  ๘  สิกขาบท  ชื่อปาราชิกกัณฑ์.
<span class="LineNumber"> 008 </span>	๒.  สังฆาทิเสส  ๑๗  สิกขาบท  ชื่อสัตตรสกัณฑ์.
<span class="LineNumber"> 009 </span>	๓.  นิสสัคคิยปาจิตตีย์  ๓๐  สิกขาบท  ชื่อนิสสัคคิยกัณฑ์.
<span class="LineNumber"> 010 </span>	๔.  สุทธิกปาจิตตีย์  ๑๖๖  สิกขาบท  ชื่อปาจิตติยกัณฑ์.
<span class="LineNumber"> 011 </span>	๕.  ปาฏิเทสนียะ  ๘  สิกขาบท  ชื่อปาฏิเทสนียกัณฑ์.
<span class="LineNumber"> 012 </span>	๖.  เสขิยวัตร  ๗๕  สิกขาบท  ชื่อเสขิยกัณฑ์.
<span class="LineNumber"> 013 </span>	๗.  อธิกรณสมถะ  ๗  สิกขาบท  ชื่อธิกรณสมถกัณฑ์.
<span class="LineNumber"> 014 </span>	รวมภิกขุนีวิภงค์มี  ๓๑๑ สิกขาบท  เป็นวินัยสำหรับนางภิกษุณี.
<span class="LineNumber"> 015 </span>	วิภังค์ทั้ง ๒  นี้  เรียกอีกอย่างหนึ่งว่า  <B>อุภโตวิภังค์</B>.
<span class="LineNumber"> 016 </span>	เมื่อเสร็จแล้วจึงสังคายนาขันธวรรคและปริวารวรรคต่อไป  ครั้น
<span class="LineNumber"> 017 </span>แล้วจัดเป็นคัมภีร์ได้  ๕  คัมภีร์ :-
<span class="LineNumber"> 018 </span>	๑.  คัมภีร์อาทิกรรม.
<span class="LineNumber"> 019 </span>	๒.  คัมภีร์ปาจิตตีย์.
<span class="LineNumber"> 020 </span>	๓.  คัมภีร์มหาวรรค.
<span class="LineNumber"> 021 </span>	๔.  คัมภีร์จุลวรรค.
