<span class="LineNumber"> 001 </span>	๑๑. เธอเว้นขาดจากการทัดทรงประดับ ตบแต่งร่างกาย ด้วยดอกไม้ของหอม และ      
<span class="LineNumber"> 002 </span>เครื่องประเทืองผิว อันเป็นฐานแห่งการแต่งตัว.     
<span class="LineNumber"> 003 </span>	๑๒. เธอเว้นขาดจากการนั่งนอนบนที่นั่งที่นอนอันสูงใหญ่.      
<span class="LineNumber"> 004 </span>	๑๓. เธอเว้นขาดจากการรับทองและเงิน.    
<span class="LineNumber"> 005 </span>	๑๔. เธอเว้นขาดจากการรับธัญญาหารดิบ.   
<span class="LineNumber"> 006 </span>	๑๕. เธอเว้นขาดจากการรับเนื้อดิบ.      
<span class="LineNumber"> 007 </span>	๑๖. เธอเว้นขาดจากการรับสตรีและกุมารี. 
<span class="LineNumber"> 008 </span>	๑๗. เธอเว้นขาดจากการรับทาสีและทาส.    
<span class="LineNumber"> 009 </span>	๑๘. เธอเว้นขาดจากการรับแพะและแกะ.     
<span class="LineNumber"> 010 </span>	๑๙. เธอเว้นขาดจากการรับไก่และสุกร.    
<span class="LineNumber"> 011 </span>	๒๐. เธอเว้นขาดจากการรับช้าง โค ม้า และลา.    
<span class="LineNumber"> 012 </span>	๒๑. เธอเว้นขาดจากการรับไร่นาและที่ดิน.
<span class="LineNumber"> 013 </span>	๒๒. เธอเว้นขาดจากการประกอบทูตกรรมและการรับใช้.      
<span class="LineNumber"> 014 </span>	๒๓. เธอเว้นขาดจากการซื้อการขาย.
<span class="LineNumber"> 015 </span>	๒๔. เธอเว้นขาดจากการโกงด้วยตราชั่ง การโกงด้วยของปลอม และการโกงด้วย
<span class="LineNumber"> 016 </span> เครื่องตวงวัด.      
<span class="LineNumber"> 017 </span>	๒๕. เธอเว้นขาดจากการรับสินบน การล่อลวง และการตลบตะแลง.     
<span class="LineNumber"> 018 </span>	๒๖. เธอเว้นขาดจากการตัด การฆ่า การจองจำ การตีชิง การปล้น และกรรโชก
<span class="LineNumber"> 019 </span> แม้ข้อนี้ก็เรียกว่าอนุสาสนีปาฏิหาริย์.   
<span class="LineNumber"> 020 </span>			    มัชฌิมศีล      
<span class="LineNumber"> 021 </span>	๑. ภิกษุเว้นขาดจากการพรากพืชคามและภูตคาม เช่นอย่างที่สมณพราหมณ์ผู้เจริญ 
<span class="LineNumber"> 022 </span>บางจำพวก ฉันโภชนะที่เขาให้ด้วยศรัทธาแล้ว ยังประกอบการพรากพืชคามและภูตคามเห็น 
<span class="LineNumber"> 023 </span>ปานนี้ คือ พืชเกิดแต่เหง้า พืชเกิดแต่ลำต้น พืชเกิดแต่ผล พืชเกิดแต่ยอด พืชเกิดแต่เมล็ด      
<span class="LineNumber"> 024 </span>เป็นที่ครบห้า แม้ข้อนี้ก็เรียกว่าอนุสาสนีปาฏิหาริย์.    
