<span class="LineNumber"> 001 </span>	รู้ในสิ่งที่ไม่มีโทษว่ามีโทษ และมีปกติเห็นในสิ่งที่มีโทษว่าไม่มีโทษ 
<span class="LineNumber"> 002 </span>	ย่อมไปสู่ทุคติ สัตว์ทั้งหลายผู้ถือมั่นสัมมาทิฐิ รู้ธรรมที่มีโทษโดย
<span class="LineNumber"> 003 </span>	ความเป็นธรรมที่มีโทษ และรู้ธรรมที่หาโทษมิได้โดยความเป็นธรรมหา
<span class="LineNumber"> 004 </span>	โทษมิได้ ย่อมไปสู่สุคติ ฯ
<span class="LineNumber"> 005 </span>	จบนิรยวรรคที่ ๒๒
<span class="LineNumber"> 006 </span>	คาถาธรรมบท นาควรรคที่ ๒๓
<span class="LineNumber"> 007 </span>	[๓๓] เราจักอดกลั้นซึ่งคำล่วงเกิน ดุจช้างอดทนซึ่งลูกศรที่ออกมาจากแล่ง
<span class="LineNumber"> 008 </span>	ในสงคราม ฉะนั้น เพราะคนทุศีลมีมาก ชนทั้งหลายย่อมนำสัตว์
<span class="LineNumber"> 009 </span>	พาหนะที่ฝึกหัดแล้วไปสู่ที่ชุมนุม พระราชาย่อมทรงพาหนะที่ได้ฝึกหัด
<span class="LineNumber"> 010 </span>	แล้ว ในหมู่มนุษย์คนที่ได้ฝึกแล้ว อดทนซึ่งคำล่วงเกินได้ เป็นผู้ประเสริฐ
<span class="LineNumber"> 011 </span>	สุด ม้าอัสดร ม้าอาชาไนย ม้าสินธพ และช้างกุญชรผู้มหานาคชนิด
<span class="LineNumber"> 012 </span>	ที่นายควานฝึกแล้ว จึงเป็นสัตว์ประเสริฐ บุคคลผู้มีตนอันฝึกแล้ว 
<span class="LineNumber"> 013 </span>	ประเสริฐกว่าพาหนะเหล่านั้น บุคคลผู้ฝึกตนแล้ว พึงไปสู่ทิศที่ยังไม่เคย
<span class="LineNumber"> 014 </span>	ไปด้วยตนที่ฝึกแล้ว ฝึกดีแล้ว    ได้ ฉันใด บุคคลพึงไปสู่ทิศที่ยังไม่เคย
<span class="LineNumber"> 015 </span>	ไปแล้วด้วยยานเหล่านี้ ฉันนั้น หาได้ไม่ กุญชรนามว่า ธนปาลกะ ผู้
<span class="LineNumber"> 016 </span>	ตกมันจัด ห้ามได้ยาก เขาผูกไว้แล้ว ย่อมไม่บริโภคอาหารกุญชรย่อมระลึก
<span class="LineNumber"> 017 </span>	ถึงป่าเป็นที่อยู่แห่งช้าง เมื่อใด บุคคลเป็นผู้บริโภคมาก มักง่วงซึม 
<span class="LineNumber"> 018 </span>	นอนหลับ พลิกกลับไปมา ดุจสุกรใหญ่อันบุคคลปรนปรือด้วยเหยื่อ เมื่อ
<span class="LineNumber"> 019 </span>	นั้น บุคคลนั้นเป็นคนเขลาเข้าห้องบ่อยๆ จิตนี้ได้เที่ยวไปสู่ที่จาริกตาม
<span class="LineNumber"> 020 </span>	ความปรารถนา ตามความใคร่ ตามความสุข ในกาลก่อนวันนี้ เราจักข่ม
<span class="LineNumber"> 021 </span>	จิตนั้นโดยอุบายอันแยบคาย ดุจนายควานช้างผู้ถือขอข่มช้างผู้ตกมัน
<span class="LineNumber"> 022 </span>	ฉะนั้น ท่านทั้งหลายจงเป็นผู้ยินดีในความไม่ประมาท จงตามรักษาจิต
<span class="LineNumber"> 023 </span>	ของตน จงถอนตนขึ้นจากหล่มคือกิเลสที่ถอนได้ยาก ดุจกุญชรผู้จม
<span class="LineNumber"> 024 </span>	แล้วในเปือกตมถอนตนขึ้นได้ ฉะนั้น ถ้าว่าบุคคลพึงได้สหายผู้มี
<span class="LineNumber"> 025 </span>	ปัญญารักษาตน ผู้เที่ยวไปด้วยกัน มีปกติอยู่ด้วยกรรมดี เป็นนักปราชญ์
