<span class="LineNumber"> 001 </span>	ยังเธอทั้งหลายผู้ตกอยู่ในอำนาจให้ลุ่มหลงเลย เธอทั้งหลายจงข้าม
<span class="LineNumber"> 002 </span>	ตัณหาอันซ่านไปในอารมณ์ต่างๆ ซึ่งเป็นเหตุให้เทวดาและมนุษย์ผู้มี
<span class="LineNumber"> 003 </span>	ความต้องการอาศัยรูป เป็นต้น ดำรงอยู่ขณะอย่าได้ล่วงเธอทั้งหลาย
<span class="LineNumber"> 004 </span>	ไปเสีย เพราะว่าผู้ล่วงขณะเสียแล้ว เป็นผู้ยัดเยียดกันในนรกเศร้า
<span class="LineNumber"> 005 </span>	โศกอยู่ ความประมาทเป็นดุจธุลี ตกต้องแล้วเพราะความมัวเมาในปฐม
<span class="LineNumber"> 006 </span>	วัยนอกนี้ความประมาทเป็นดุจธุลี ตกต้องแล้วเพราะความมัวเมาในวัย 
<span class="LineNumber"> 007 </span>	เพราะฉะนั้น กุลบุตรผู้เป็นบัณฑิต พึงถอนลูกศร คือกิเลสมีราคะ
<span class="LineNumber"> 008 </span>	เป็นต้นของตนเสีย ด้วยความไม่ประมาทและด้วยวิชชา ฯ
<span class="LineNumber"> 009 </span>	จบอุฏฐานสูตรที่ ๑๐
<span class="LineNumber"> 010 </span>	ราหุลสูตรที่ ๑๑
<span class="LineNumber"> 011 </span>	พระผู้มีพระภาคตรัสถามว่า
<span class="LineNumber"> 012 </span>	[๓๒๘] เธอย่อมไม่ดูหมิ่นบัณฑิต เพราะการอยู่ร่วมกันเนืองๆ แลหรือ 
<span class="LineNumber"> 013 </span>	การทรงคบเพลิง เพื่อมนุษย์ทั้งหลาย เธอนอบน้อมแล้วแลหรือ ฯ
<span class="LineNumber"> 014 </span>พระราหุลกราบทูลว่า
<span class="LineNumber"> 015 </span>	ข้าพระองค์ย่อมไม่ดูหมิ่นบัณฑิต เพราะการอยู่ร่วมกันเนืองๆการทรง
<span class="LineNumber"> 016 </span>	คบเพลิงเพื่อมนุษย์ทั้งหลาย ข้าพระองค์นอบน้อมแล้วเป็นนิตย์ ฯ
<span class="LineNumber"> 017 </span>พระผู้มีพระภาคตรัสว่า
<span class="LineNumber"> 018 </span>	เธอละกามคุณห้ามีรูปเป็นที่รัก เป็นที่รื่นรมย์ใจ ออกบวชด้วย
<span class="LineNumber"> 019 </span>	ศรัทธาแล้ว จงกระทำที่สุดทุกข์เถิด เธอจงคบกัลยาณมิตร จงเสพที่นอน
<span class="LineNumber"> 020 </span>	ที่นั่งอันสงัดเงียบ ปราศจากเสียงกึกก้อง จงรู้จักประมาณในโภชนะ 
<span class="LineNumber"> 021 </span>	เธออย่าได้กระทำความอยากในวัตถุเป็นที่เกิดตัณหาเหล่านี้ คือ จีวร 
<span class="LineNumber"> 022 </span>	บิณฑบาตที่นอน ที่นั่ง และปัจจัย เธออย่ากลับมาสู่โลกนี้อีก 
<span class="LineNumber"> 023 </span>	จงเป็นผู้สำรวมในปาฏิโมกข์และในอินทรีย์ ๕ จงมีสติไปแล้วในกาย
<span class="LineNumber"> 024 </span>	จงเป็นผู้มากไปด้วยความเบื่อหน่าย จงเว้นสุภนิมิต อันก่อให้เกิดความ
