<span class="LineNumber"> 001 </span>	ว่าเป็นพราหมณ์ เรากล่าวผู้ไม่มีความอาลัย รู้แล้วทั่วถึง ไม่มีความ
<span class="LineNumber"> 002 </span>	สงสัย หยั่งลงสู่นิพพาน ได้บรรลุแล้วโดยลำดับ ว่าเป็นพราหมณ์ 
<span class="LineNumber"> 003 </span>	เรากล่าวผู้ละทิ้งบุญและบาปทั้ง ๒ ล่วงธรรมเป็นเครื่องข้องได้แล้ว ไม่
<span class="LineNumber"> 004 </span>	มีความเศร้าโศก ปราศจากธุลี บริสุทธิ์แล้วว่าเป็นพราหมณ์ เรากล่าวผู้
<span class="LineNumber"> 005 </span>	มีความยินดีในภพหมดสิ้นแล้วผู้บริสุทธิ์ มีจิตผ่องใส ไม่ขุ่นมัวดุจ
<span class="LineNumber"> 006 </span>	พระจันทร์ที่ปราศจากมลทิน ว่าเป็นพราหมณ์ เรากล่าวผู้ล่วงทางอ้อม 
<span class="LineNumber"> 007 </span>	หล่มสงสาร โมหะเสียได้ เป็นผู้ข้ามถึงฝั่ง เพ่งฌาน ไม่หวั่นไหว 
<span class="LineNumber"> 008 </span>	ไม่มีความสงสัย ดับกิเลสได้แล้วเพราะไม่ถือมั่นว่าเป็นพราหมณ์ เรา
<span class="LineNumber"> 009 </span>	กล่าวผู้ละกามในโลกนี้ได้เด็ดขาดเป็นผู้ไม่มีเรือน บวชเสียได้ มี
<span class="LineNumber"> 010 </span>	กามราคะหมดสิ้นแล้ว ว่าเป็นพราหมณ์ เรากล่าวผู้ละตัณหาในโลกนี้ได้
<span class="LineNumber"> 011 </span>	เด็ดขาด เป็นผู้ไม่มีเรือน งดเว้น มีตัณหาและภพหมดสิ้นแล้ว ว่า
<span class="LineNumber"> 012 </span>	เป็นพราหมณ์ เรากล่าวผู้ละโยคะที่เป็นของมนุษย์ แล้วล่วงโยคะที่
<span class="LineNumber"> 013 </span>	เป็นของทิพย์เสียได้ ผู้พรากแล้วจากโยคะทั้งปวงว่าเป็นพราหมณ์ เรา
<span class="LineNumber"> 014 </span>	กล่าวผู้ละความยินดีและความไม่ยินดีเป็นผู้เยือกเย็น หาอุปธิมิได้ 
<span class="LineNumber"> 015 </span>	ผู้ครอบงำโลกทั้งปวง มีความเพียร ว่าเป็นพราหมณ์ เรากล่าวผู้รู้จุติ
<span class="LineNumber"> 016 </span>	และอุปบัติของสัตว์ทั้งหลาย โดยอาการทั้งปวง ผู้ไม่ข้อง ไปดี ตรัสรู้
<span class="LineNumber"> 017 </span>	แล้วว่าเป็นพราหมณ์ เรากล่าวผู้ที่เทวดา คนธรรพ์ และมนุษย์รู้คติไม่
<span class="LineNumber"> 018 </span>	ได้ ผู้สิ้นอาสวะแล้ว เป็นพระอรหันต์ ว่าเป็นพราหมณ์เรากล่าวผู้ไม่
<span class="LineNumber"> 019 </span>	มีเครื่องกังวลในขันธ์ทั้งที่เป็นอดีต อนาคตและปัจจุบัน ไม่มีเครื่อง
<span class="LineNumber"> 020 </span>	กังวล ไม่ยึดถือ ว่าเป็นพราหมณ์เรากล่าวผู้องอาจ ประเสริฐ เป็น
<span class="LineNumber"> 021 </span>	นักปราชญ์ แสวงหาคุณใหญ่ชนะมาร ไม่มีความหวั่นไหว ล้างกิเลส
<span class="LineNumber"> 022 </span>	หมด ตรัสรู้แล้ว ว่าเป็นพราหมณ์ เรากล่าวผู้ระลึกชาติก่อนๆ ได้
<span class="LineNumber"> 023 </span>	เห็นสวรรค์และอบาย และถึงความสิ้นไปแห่งชาติแล้ว ว่าเป็นพราหมณ์ 
<span class="LineNumber"> 024 </span>	นามและโคตรที่เขากำหนดกัน เป็นบัญญัติในโลก นามและโคตรมา
<span class="LineNumber"> 025 </span>	แล้วเพราะการรู้ตามกันมา ญาติสาโลหิตทั้งหลาย กำหนดไว้ในกาลที่
<span class="LineNumber"> 026 </span>	บุคคลเกิดแล้วนั้นๆนามและโคตรที่กำหนดกันแล้วนี้ เป็นความเห็น
<span class="LineNumber"> 027 </span>	ของพวกคนผู้ไม่รู้ ซึ่งสืบเนื่องกันมาสิ้นกาลนาน พวกคนผู้ไม่รู้ย่อม
