<span class="LineNumber"> 001 </span>	กทมฺพา กทลี เจว          		อิสิมุคฺคา จ โรปิตา  
<span class="LineNumber"> 002 </span>	ธุวํ ผลานิ ธาเรนฺติ         		โสภยนฺติ มมสฺสมํ ฯ  
<span class="LineNumber"> 003 </span>	หรีตกา อามลกา           		อมฺพา ชมฺพู วิเภทกา ๑  
<span class="LineNumber"> 004 </span>	โกลา ภลฺลาตกา เพลฺลา ๒  ผลิโน มม อสฺสเม ฯ  
<span class="LineNumber"> 005 </span>	อวิทูเร โปกฺขรณี           		สุปติตฺถา มโนรมา  
<span class="LineNumber"> 006 </span>	มนฺทาลเกหิ สฺฉนฺนา        ปทุมุปฺปลเกหิ จ ฯ  
<span class="LineNumber"> 007 </span>	คพฺภํ คณฺหนฺติ ปทุมา         	อฺเ ปุปฺผนฺติ เกสริ  
<span class="LineNumber"> 008 </span>	โอปตฺตกณฺณิกา เจว         	ปุปฺผนฺติ มม อสฺสเม ฯ  
<span class="LineNumber"> 009 </span>	ปา€ีนา ปาวุสา มจฺฉา       	วลชา ๓ มุฺชโรหิตา  
<span class="LineNumber"> 010 </span>	อจฺโฉทกมฺหิ  วิจรํ          	โสภยนฺติ มมสฺสมํ ฯ  
<span class="LineNumber"> 011 </span>	นยิตา อมฺพคนฺธิ จ          	อนุกุเล จ เกตกา  
<span class="LineNumber"> 012 </span>	ทิพฺพา คนฺธา สมฺปวนฺตา      โสภยนฺติ มมสฺสมํ ฯ  
<span class="LineNumber"> 013 </span>	มธุภึเสหิ สวนฺติ ๔         	ขีรสปฺปิมุฬาลิภิ  
<span class="LineNumber"> 014 </span>	ทิพฺพา คนฺธา สมฺปวนฺตา      โสภยนฺติ มมสฺสมํ ฯ  
<span class="LineNumber"> 015 </span>	ปุฬินา โสภนา ตตฺถ         อากิณฺณา ชลเสวิตา  
<span class="LineNumber"> 016 </span>	โอปุปฺผา ๕ ปุปฺผิตา เสตา   โสภยนฺติ มมสฺสมํ ฯ  
<span class="LineNumber"> 017 </span>	ชฏาภารภริตา จ           อชินุตฺตรวาสิโน  
<span class="LineNumber"> 018 </span>	วากจีรธรา สพฺเพ          โสภยนฺติ มมสฺสมํ ฯ  
<span class="LineNumber"> 019 </span>	ยุคมตฺตมเปกฺขนฺตา          นิปกา สนฺตวุตฺติโน  
<span class="LineNumber"> 020 </span>	กามเคเธ ๖ อนเปกฺขา     วสนฺติ มม อสฺสเม ฯ  
<span class="LineNumber"> 021 </span>#๑ ม. ยุ. วิภีตกา ฯ สพฺพตฺถ อีทิสเมว ฯ  ๒ ม. พิลฺลา ฯ สพฺพตฺถ อีทิสเมว ฯ  
<span class="LineNumber"> 022 </span>#๓ ม. พลชา ฯ ยุ ชลชา ฯ สพฺพตฺถ อีทิสเมว ฯ ๔ ม. ยุ. มธุภิสมฺหา สวติ ฯ  
<span class="LineNumber"> 023 </span>#๕ ม. โอปุปฺผา--สนฺติ ฯ ยุ. โอวฏฺฏา--สนฺติ ฯ ๖ ม. กามโภเค ฯ  
