<span class="LineNumber"> 001 </span>	วสฺสสตสหสฺสานิ            อายุ วิชฺชติ ตาวเท  
<span class="LineNumber"> 002 </span>	ตาวตา ติฏฺ€มาโน โส       ตาเรสิ ชนตํ พหุํ ฯ  
<span class="LineNumber"> 003 </span>	ตทาหํ หํสวติยํ             เสฏฺ€ิปุตฺโต มหายโส  
<span class="LineNumber"> 004 </span>	อุเปตฺวา โลกปชฺโชตํ        อสฺโสสึ ธมฺมเทสนํ ฯ  
<span class="LineNumber"> 005 </span>	เสนาสนานิ ภิกฺขูนํ          ปฺาเปนฺตํ สสาวกํ  
<span class="LineNumber"> 006 </span>	กิตฺตยนฺตสฺส วจนํ           สุณิตฺวา มุทิโต อหํ ฯ  
<span class="LineNumber"> 007 </span>	อธิการํ สสงฺฆสฺส           กตฺวา ตสฺส มเหสิโน  
<span class="LineNumber"> 008 </span>	นิปจฺจ สิรสา ปาเท         ตณฺ€านํ อภิปตฺถยึ ฯ  
<span class="LineNumber"> 009 </span>	ตทา ๑ หิ โส มหาวีโร     มม กมฺมํ ปกิตฺตยิ  
<span class="LineNumber"> 010 </span>	โยยํ สสงฺฆํ โภเชสิ         สตฺตาหํ โลกนายกํ ฯ  
<span class="LineNumber"> 011 </span>	โสยํ กมลปตฺตกฺโข          สีหํโส กนกตฺตโจ  
<span class="LineNumber"> 012 </span>	มม ปาทมูเล นิปติ ๒       ปตฺถยํ ๓ €านมุตฺตมํ ฯ  
<span class="LineNumber"> 013 </span>	สตสหสฺเส อิโต กปฺเป       โอกฺกากกุลสมฺภโว  
<span class="LineNumber"> 014 </span>	โคตโม นาม นาเมน        สตฺถา โลเก ภวิสฺสติ ฯ  
<span class="LineNumber"> 015 </span>	สาวโก ตสฺส พุทฺธสฺส        ทพฺโพ นาเมน วิสฺสุโต  
<span class="LineNumber"> 016 </span>	เสนาสนปฺาปโก          อคฺโค เหสฺสติยํ ตถา ๔ ฯ  
<span class="LineNumber"> 017 </span>	เตน กมฺเมน สุกเตน        เจตนาปณิธีหิ จ  
<span class="LineNumber"> 018 </span>	ชหิตฺวา มานุสํ เทหํ         ตาวตึสํ อคฺฉหํ ฯ  
<span class="LineNumber"> 019 </span>	สตานํ ตีณิกฺขตฺตุฺจ          เทวรชฺชมการยึ  
<span class="LineNumber"> 020 </span>	ตถา ๕ ปฺจสตกฺขตฺตุํ       จกฺกวตฺติ อโหสหํ ฯ  
<span class="LineNumber"> 021 </span>#๑ ยุ. ตทาหํ ส ฯ ๒ ยุ. ปติโต ฯ ๓ ยุ. ปตฺถยิ ฯ ๔ ม. ยุ. ตทา ฯ ๕ ม.  
<span class="LineNumber"> 022 </span>#ยุ. สตานํ ฯ  
