<span class="LineNumber"> 001 </span>	ชฏาภารสฺส ๑ ภริโต       กมณฺฑลุธโร ตทา  
<span class="LineNumber"> 002 </span>	อุตฺตมตฺถํ คเวสนฺโต         ปวนา นิกฺขมึ ๒ ตทา ฯ  
<span class="LineNumber"> 003 </span>	จุลฺลาสีติสหสฺสานิ           สิสฺสา มยฺหํ อุปฏฺ€หุํ  
<span class="LineNumber"> 004 </span>	สกกมฺมาภิปสุตา            วสนฺติ ปวเน ตทา ฯ  
<span class="LineNumber"> 005 </span>	อสฺสมา อภินิกฺขมฺม          อกํ ปุฬินเจติยํ  
<span class="LineNumber"> 006 </span>	นานาปุปฺผํ สมาเนตฺวา       ตํ เจติยํ อปูชยึ ฯ  
<span class="LineNumber"> 007 </span>	ตตฺถ จิตฺตํ ปสาเทตฺวา       อสฺสมํ ปวิสามหํ  
<span class="LineNumber"> 008 </span>	สพฺเพ สิสฺสา สมาคนฺตฺวา     เอตมตฺถํ อปุจฺฉิสุํ ๓ ฯ  
<span class="LineNumber"> 009 </span>	ปุฬิเนน กโต ถูโป          ยํ ตฺวํ เทว นมสฺสสิ  
<span class="LineNumber"> 010 </span>	มยมฺปิ าตุมิจฺฉาม          ปุฏฺโ€ อาจิกฺข โน ตุวํ ฯ  
<span class="LineNumber"> 011 </span>	ทิฏฺ€า โน ๔ โว มนฺตปเท   จกฺขุมนฺโต มหายสา  
<span class="LineNumber"> 012 </span>	เต โข อหํ นมสฺสามิ        พุทฺธเสฏฺเ€ มหายเส ฯ  
<span class="LineNumber"> 013 </span>	กีทิสา เต มหาวีรา         สพฺพฺู โลกนายกา  
<span class="LineNumber"> 014 </span>	กถํวณฺณา กถํสีลา           กีทิสา เต มหายสา ฯ  
<span class="LineNumber"> 015 </span>	พตฺตึสลกฺขณา พุทฺธา         จตฺตาริว ๕ ทิชาปิจ  
<span class="LineNumber"> 016 </span>	เนตฺตา โคปขุมา ๖ เตสํ    ชิฺชุกผลสนฺนิภา ฯ  
<span class="LineNumber"> 017 </span>	คจฺฉมานา จ เต พุทฺธา      ยุคมตฺตฺจ เปกฺขเร  
<span class="LineNumber"> 018 </span>	น เตสํ ชาณุ นทติ          สนฺธิสทฺโท น สุยฺยติ ฯ  
<span class="LineNumber"> 019 </span>	คจฺฉมานา จ สุคตา         อตุริตาว ๗ คจฺฉเร  
<span class="LineNumber"> 020 </span>	ป€มํ ทกฺขิณํ ปาทํ           พุทฺธานํ เอส ธมฺมตา ฯ  
<span class="LineNumber"> 021 </span>#๑ ม. ยุ. ชฏาภาเรน ฯ ๒ ยุ. อภินิกฺขมึ ฯ ๓ ม. ยุ. ปุจฺฉึสุ มํ ฯ ๔ ม. ... นุ  
<span class="LineNumber"> 022 </span>#มนฺตปเท ฯ ๕ ม. ยุ. จตฺตาฬีส ฯ ๖ ยุ. โคปมุขา ฯ ๗ ม. อุทฺธรนฺตาว ฯ  
