<span class="LineNumber"> 001 </span>	กิเลสา ฌาปิตา มยฺหํ        ภวา สพฺเพ สมูหตา  
<span class="LineNumber"> 002 </span>	นาคีว พนฺธนํ เฉตฺวา        วิหรามิ อนาสวา ฯ  
<span class="LineNumber"> 003 </span>	สฺวาคตํ วต เม อาสิ        พุทฺธเสฏฺ€สฺส สนฺติเก  
<span class="LineNumber"> 004 </span>	ติสฺโส วิชฺชา อนุปฺปตฺตา      กตํ พุทฺธสฺส สาสนํ ฯ  
<span class="LineNumber"> 005 </span>	ปฏิสมฺภิทา จตสฺโส          วิโมกฺขาปิจ อฏฺ€ิเม  
<span class="LineNumber"> 006 </span>	ฉฬภิฺา สจฺฉิกตา          กตํ พุทฺธสฺส สาสนนฺติ ฯ  
<span class="LineNumber"> 007 </span>	อิตฺถํ สุทํ อายสฺมา สลฬปุปฺผิกา ภิกฺขุนี อิมา คาถาโย อภาสิตฺถาติ ฯ  
<span class="LineNumber"> 008 </span>		สลฬปุปฺผิกาเถริยา อปทานํ สมตฺตํ ฯz  
<span class="LineNumber"> 009 </span>		ตติยํ โมทกทายิกาเถริยาปทานํ (๑๓)  
<span class="LineNumber"> 010 </span>  [๑๕๓] นคเร พนฺธุมติยา           กุมฺภทาสี อโหสหํ  
<span class="LineNumber"> 011 </span>	มม ภาคํ คเหตฺวาน         คจฺฉํ อุทกหาริเก ๑ ฯ  
<span class="LineNumber"> 012 </span>	ปนฺถมฺหิ สมณํ ทิสฺวา         สนฺตจิตฺตํ สมาหิตํ  
<span class="LineNumber"> 013 </span>	ปสนฺนจิตฺตา สุมนา          โมทเก ตีณิทาสหํ ฯ  
<span class="LineNumber"> 014 </span>	เตน กมฺเมน สุกเตน        เจตนาปณิธีหิ จ  
<span class="LineNumber"> 015 </span>	เอกูนตึส ๒ กปฺปานิ        วินิปาตํ น อคฺฉหํ ฯ  
<span class="LineNumber"> 016 </span>	สมฺปตฺติฺจ กริตฺวาน         สพฺพํ อนุภวึ อหํ  
<span class="LineNumber"> 017 </span>	โมทเก ตีณิ ทตฺวาน         ปตฺตาหํ อจลํ ปทํ ฯ  
<span class="LineNumber"> 018 </span>	กิเลสา ฌาปิตา มยฺหํ        ภวา สพฺเพ สมูหตา  
<span class="LineNumber"> 019 </span>	นาคีว พนฺธนํ เฉตฺวา        วิหรามิ อนาสวา ฯ  
<span class="LineNumber"> 020 </span>#๑ ม. ยุ. อุทกหาริกา ฯ ๒ ม. ยุ. เอกนวุติ ฯ ๓ ม. สมฺปตฺติตํ ฯ ยุ. สมฺปตฺตึ ตํ ฯ  
