<span class="LineNumber"> 001 </span>	ตทา มหาปริสติ            มหาปุริสสาวกํ  
<span class="LineNumber"> 002 </span>	€เปนฺตํ เอตทคฺคมฺหิ         สุตฺวาน มุทิโต อหํ ฯ  
<span class="LineNumber"> 003 </span>	มหตา ปริวาเรน           นิมนฺเตตฺวา มหาชินํ  
<span class="LineNumber"> 004 </span>	พฺราหฺมณานํ สหสฺเสน        สห ทานมทาสหํ ฯ  
<span class="LineNumber"> 005 </span>	มหาทานํ ททิตฺวาน          อภิวาทิย นายกํ  
<span class="LineNumber"> 006 </span>	เอกมนฺตํ €ิโต หฏฺโ€        อิทํ วจนมพฺรวึ ฯ  
<span class="LineNumber"> 007 </span>	ตยิ สทฺธาย เม วีร         อธิการคุเณน จ  
<span class="LineNumber"> 008 </span>	ปริสา มหตี โหตุ           นิพฺพตฺตสฺส ตหึ ตหึ ฯ  
<span class="LineNumber"> 009 </span>	ตทา อโวจ ปริสํ           คชคชฺชิตสุสฺสโร  
<span class="LineNumber"> 010 </span>	กรวิกรุโท ๑ สตฺถา        เอตํ ปสฺสถ พฺราหฺมณํ ฯ  
<span class="LineNumber"> 011 </span>	เหมวณฺณํ มหาพาหุํ          กมลานนโลจนํ  
<span class="LineNumber"> 012 </span>	อุทฺธคฺคตนุชํ หฏฺ€ํ           สทฺธาวนฺตํ คุเณ มม ฯ  
<span class="LineNumber"> 013 </span>	เอส ปตฺถยิ ๒ ตํ €านํ      สีหสรสฺส ๓ ภิกฺขุโน  
<span class="LineNumber"> 014 </span>	อนาคตมฺหิ อทฺธาเน         ลจฺฉเสตํ มโนรถํ ฯ  
<span class="LineNumber"> 015 </span>	สตสหสฺเส อิโต กปฺเป       โอกฺกากกุลสมฺภโว  
<span class="LineNumber"> 016 </span>	โคตโม นาม นาเมน        สตฺถา โลเก ภวิสฺสติ ฯ  
<span class="LineNumber"> 017 </span>	ตสฺส ธมฺเมสุ ทายาโท       โอรโส ธมฺมนิมฺมิโต  
<span class="LineNumber"> 018 </span>	กสฺสโป นาม นาเมน        เหสฺสติ สตฺถุสาวโก ฯ  
<span class="LineNumber"> 019 </span>	อิโต เทฺวนวุเต กปฺเป       อหุ สตฺถา อนุตฺตโร  
<span class="LineNumber"> 020 </span>	อนูปโม อสทิโส            ผุสฺโส โลกคฺคนายโก ฯ  
<span class="LineNumber"> 021 </span>#๑ ม. กรวีกรุโต ฯ ๒ ม. ปตฺถยเต ฯ อิโต ปรํ อีทิสเมว ฯ ๓ ม. ยุ. สีหโฆสสฺส ฯ  
