<span class="LineNumber"> 001 </span>		ปฺจมํ ปฺจทีปทายิกาเถริยาปทานํ (๑๕)  
<span class="LineNumber"> 002 </span>  [๑๕๕] นคเร หํสวติยา            จาริกา ๑ อาสหํ ตทา  
<span class="LineNumber"> 003 </span>	อาราเมน ๒ วิหาเรน      จรามิ กุสลตฺถิกา ฯ  
<span class="LineNumber"> 004 </span>	กาฬปกฺขมฺหิ ทิวเส          อทฺทสํ โพธิมุตฺตมํ  
<span class="LineNumber"> 005 </span>	ตตฺถ จิตฺตํ ปสาเทตฺวา       โพธิมูเล นิสีทหํ ฯ  
<span class="LineNumber"> 006 </span>	ครุจิตฺตํ อุปฏฺเ€ตฺวา         สิเร กตฺวาน อฺชลึ  
<span class="LineNumber"> 007 </span>	โสมนสฺสํ ปเวเทตฺวา        เอวํ จินฺเตสิ ตาวเท ฯ  
<span class="LineNumber"> 008 </span>	ยทิ พุทฺโธ อมิตคุโณ         อสมปฺปฏิปุคฺคโล  
<span class="LineNumber"> 009 </span>	ทสฺเสตุ ปาฏิหีรํ เม         โพธิ โอภาสตุ อยํ ฯ  
<span class="LineNumber"> 010 </span>	สห อาวชฺชิเต มยฺหํ         โพธิ ปชฺชลิ ตาวเท  
<span class="LineNumber"> 011 </span>	สพฺพโสวณฺณมยา อาสิ        ทิสา สพฺพา วิโรจติ ฯ  
<span class="LineNumber"> 012 </span>	สตฺตรตฺตินฺทิวํ ตตฺถ          โพธิมูเล นิสีทหํ  
<span class="LineNumber"> 013 </span>	สตฺตเม ทิวเส ปตฺเต        ทีปปูชํ อกาสหํ ฯ  
<span class="LineNumber"> 014 </span>	อาสนํ ปริวาเรตฺวา         ปฺจ ทีปานิ ปชฺชลล  
<span class="LineNumber"> 015 </span>	ยาว อุเทติ สุริโย          ทีปา เม ปชฺชลล ตทา ฯ  
<span class="LineNumber"> 016 </span>	เตน กมฺเมน สุกเตน        เจตนาปณิธีหิ จ  
<span class="LineNumber"> 017 </span>	ชหิตฺวา มานุสํ เทหํ         ตาวตึสํ อคฺฉหํ ฯ  
<span class="LineNumber"> 018 </span>	ตตฺถ เม สุกตํ พฺยมฺหํ        ปฺจทีปาติ ๓ วุจฺจติ  
<span class="LineNumber"> 019 </span>	สฏฺ€ิโยชนมุพฺเพธํ           ตึสโยชนวิตฺถตํ ฯ  
<span class="LineNumber"> 020 </span>#๑ โป. จรีติ ฯ ม. ยุ. จาริกี ฯ ๒ โป. ม. จ อารามํ ฯ ๓ ยุ. ปฺจทีปีติ ฯ  
