<span class="LineNumber"> 001 </span>		    จตุตฺโถ ขตฺติยกฺาวคฺโค  
<span class="LineNumber"> 002 </span>		ป€มํ อฏฺ€ารสสหสฺสขตฺติยกฺาเถรีนมปทานํ (๓๑)  
<span class="LineNumber"> 003 </span>  [๑๗๑] ภวา สพฺเพ ปริกฺขีณา        ภวสนฺธิ ๑ วิโมจิตา  
<span class="LineNumber"> 004 </span>	สพฺพาสวา จ โน นตฺถิ       อาโรเจม มหามุเน ฯ  
<span class="LineNumber"> 005 </span>	ปริกมฺมฺจ ๒ กุสลํ         ยงฺกิฺจิ สาธุ ๓ ปตฺถิตํ  
<span class="LineNumber"> 006 </span>	ปริโภคํ ๔ มยา ทินฺนํ       ตุยฺหตฺถาย มหามุเน ฯ  
<span class="LineNumber"> 007 </span>	พุทฺธปจฺเจกพุทฺธานํ          สาวกานฺจ ปตฺถิตํ  
<span class="LineNumber"> 008 </span>	ปริโภคํ มยา ทินฺนํ          ตุยฺหตฺถาย มหามุเน ฯ  
<span class="LineNumber"> 009 </span>	อุจฺจานีจํ มยา กมฺมํ         ภิกฺขูนํ สาธุ ปตฺถิตํ  
<span class="LineNumber"> 010 </span>	อุจฺจากุลปริกฺกมฺมํ           กตเมฺหหิ ๕ มหามุเน ฯ  
<span class="LineNumber"> 011 </span>	เตเนว สุกฺกมูเลน          โจทิตา กมฺมสมฺปทา  
<span class="LineNumber"> 012 </span>	มานุสิกมติกฺกนฺตา           ชายึสุ ขตฺติเย กุเล ฯ  
<span class="LineNumber"> 013 </span>	อุปจิเต ๖ กเต กมฺเม      ชาติยา จาปิ ๗ เอกโต  
<span class="LineNumber"> 014 </span>	ปจฺฉิเม เอกโต ชาตา       ขตฺติยา กุลสมฺภวา ฯ  
<span class="LineNumber"> 015 </span>	รูปวตี โภควตี             ลาภสกฺการปูชิตา  
<span class="LineNumber"> 016 </span>	อนฺเตปุเร มหาวีร          เทวานํ อิว นนฺทเน ฯ  
<span class="LineNumber"> 017 </span>	นิพฺพินฺทิตฺวา อคารมฺหา       ปพฺพชิมฺหานคาริยํ  
<span class="LineNumber"> 018 </span>	กติปาหํ อุปาทาย           สพฺพา ปตฺตามฺห นิพฺพุตึ ฯ  
<span class="LineNumber"> 019 </span>#๑ ม. ภวา สนฺติ ... ฯ ๒ ม. ยุ. ปุริมํ กุสลํ กมฺมํ ฯ ๓ โป. ยุ. สพฺพํ ฯ  
<span class="LineNumber"> 020 </span>#๔ ม. ปริโภคมยํ ฯ ยุ. ปริโภคํ อยํ ฯ อิโต ปรํ อีทิสเมว ฯ ๕ ม. กตเมตํ ฯ  
<span class="LineNumber"> 021 </span>#๖ ม. อุปฺปตฺเตจ ฯ ยุ. อุปฺปตฺเตว ฯ ๗ ม. วาปิ ฯ  
