<span class="LineNumber"> 001 </span>	ทาเน จ คหเณ เจว        อปเจ ปทุเสปิจ  
<span class="LineNumber"> 002 </span>	สมจิตฺตมุขํ ๑ ทิสฺวา        ตทาหํ สํวิชึ ภุสํ ฯ  
<span class="LineNumber"> 003 </span>	ปุโน ปตฺตํ คเหตฺวาน        โสธยิตฺวา สุคนฺธินา  
<span class="LineNumber"> 004 </span>	ปสนฺนจิตฺตา ปูเรตฺวา        สฆตํ สกฺกรํ อทํ ฯ  
<span class="LineNumber"> 005 </span>	ยตฺถ ยตฺถูปปชฺชามิ          สุรูปา โหมิ ทานโต  
<span class="LineNumber"> 006 </span>	พุทฺธสฺส อปกาเรน          ทุคฺคนฺธา มทเนน จ ๒ ฯ  
<span class="LineNumber"> 007 </span>	ปุโน กสฺสปธีรสฺส           นิฏฺ€าปิตมฺหิ เจติเย ๓  
<span class="LineNumber"> 008 </span>	โสวณฺณํ อิฏฺ€กํ วรํ          อทาสึ มุทิตา อหํ ฯ  
<span class="LineNumber"> 009 </span>	จตุชฺชาเตน คนฺเธน         เตมยิตฺวา ตมิฏฺ€กํ ๔  
<span class="LineNumber"> 010 </span>	มุตฺตา ทุคฺคนฺธโทสมฺหา       สพฺพงฺคสุสมาคตา ๕ ฯ  
<span class="LineNumber"> 011 </span>	สตฺตปาติสหสฺสานิ           รตเนหิ จ สตฺตหิ  
<span class="LineNumber"> 012 </span>	กาเรตฺวา ฆตปูรานิ         วฏฺฏีนิ จ สหสฺสโส ฯ  
<span class="LineNumber"> 013 </span>	ปกฺขิเปตฺวา ปทีเปตฺวา       €ปยึ สตฺต ปนฺติโย  
<span class="LineNumber"> 014 </span>	ปูชนตฺถํ โลกนาถสฺส         วิปฺปสนฺเนน เจตสา ฯ  
<span class="LineNumber"> 015 </span>	ตทาปิ ตสฺมึ ปุฺสฺมึ         ภาคินีหํ วิเสสโต  
<span class="LineNumber"> 016 </span>	ปุโน กาสีสุ สฺชาโต        สุมิตฺโต อิติ วิสฺสุโต ฯ  
<span class="LineNumber"> 017 </span>	ตสฺสาหํ ภริยา อาสึ         สุขิตา สชฺชิตา ปิยา  
<span class="LineNumber"> 018 </span>	ตทา ปจฺเจกมุนิโน          อทาสิ ฆนเวฏฺ€นํ ฯ  
<span class="LineNumber"> 019 </span>	ตสฺสาปิ ภาคินี อาสึ         โมทิตฺวา ทานมุตฺตมํ  
<span class="LineNumber"> 020 </span>	ปุโนปิ กาสิรฏฺ€มฺหิ          ชาโต โกลิยชาติยา ฯ  
<span class="LineNumber"> 021 </span>#๑ ยุ. สมจิตฺตสุขํ ทิสฺวา มหาสงฺฆํ จชึ ภุสํ ฯ ๒ ม. ยุ. วทเนน จ ฯ  
<span class="LineNumber"> 022 </span>#๓ ม. นิธายนฺตมฺหิ ฯ ยุ. นิฏฺ€ายนฺตมฺหิ ฯ ๔ ม. ยุ. นิจยิตฺวา ฯ  
<span class="LineNumber"> 023 </span>#๕ ยุ. ...สมุปฺปาคตา ฯ  
