<span class="LineNumber"> 001 </span>	สฺวาคตํ วต โน อาสิ        พุทฺธเสฏฺ€สฺส สนฺติเก  
<span class="LineNumber"> 002 </span>	ติสฺโส วิชฺชา อนุปฺปตฺตา      กตํ พุทฺธสฺส สาสนํ ฯ  
<span class="LineNumber"> 003 </span>	ปฏิสมฺภิทา จตสฺโส          วิโมกฺขาปิจ อฏฺ€ิเม  
<span class="LineNumber"> 004 </span>	ฉฬภิฺา สจฺฉิกตา          กตํ พุทฺธสฺส สาสนนฺติ ฯ  
<span class="LineNumber"> 005 </span>	อิตฺถํ สุทํ ยโสธรีปมุขานิ ทส ภิกฺขุนีสหสฺสานิ ภควโต สมฺมุขา  
<span class="LineNumber"> 006 </span>		   อิมา คาถาโย อภาสิตฺถาติ ฯ  
<span class="LineNumber"> 007 </span>		  ทสสหสฺสเถรีนํ อปทานํ สมตฺตํ ฯ  
<span class="LineNumber"> 008 </span>		ทสมํ อฏฺ€ารสเถรีสหสฺสานมปทานํ (๓๐)  
<span class="LineNumber"> 009 </span>  [๑๗๐] อฏฺ€ารสสหสฺสานิ           ภิกฺขุนี สากิยสมฺภวา  
<span class="LineNumber"> 010 </span>	ยโสธรีปมุขานิ             สมฺพุทฺธํ อุปสงฺกมม ฯ  
<span class="LineNumber"> 011 </span>	อฏฺ€ารสสหสฺสานิ ๑        สพฺพา โหนฺติ มหิทฺธิกา  
<span class="LineNumber"> 012 </span>	วนฺทนฺติ มุนิโน ปาเท        อาโรเจนฺติ ยถาพลํ ฯ  
<span class="LineNumber"> 013 </span>	ชาติ ขีณา ชรา พฺยาธิ       มรณฺจ มหามุเน ๒  
<span class="LineNumber"> 014 </span>	อนาสวํ ปทํ สนฺตํ           อมตํ ยาม นายกํ ๓ ฯ  
<span class="LineNumber"> 015 </span>	ขลิตฺจ ปุเร อตฺถิ          สพฺพาสมฺปิ มหามุนิ  
<span class="LineNumber"> 016 </span>	อปราธํ ปชานนฺติ           ขม อมฺหํ วินายก ฯ  
<span class="LineNumber"> 017 </span>	อิทฺธิฺจาปิ นิทสฺเสถ         มม สาสนการิกา  
<span class="LineNumber"> 018 </span>	ปริสานฺจ สพฺพาสํ          กงฺขํ ฉินฺทถ ยาวตา ฯ  
<span class="LineNumber"> 019 </span>	ยโสธรา ๔ มหาวีร        มนาปา ปิยทสฺสนา  
<span class="LineNumber"> 020 </span>#๑ โป. ยโสธราสหสฺสานิ ฯ ยุ. ยโสธรียสหสฺสานิ ฯ ๒ ม. ยุ. มหามุนิ ฯ  
<span class="LineNumber"> 021 </span>#๓ ม. ยุ. นายก ฯ ๔ ยุ. ยโสธรี ฯ  
