<span class="LineNumber"> 001 </span>	ตทา โกลิยปุตฺตานํ          สเตหิ สห ปฺจหิ  
<span class="LineNumber"> 002 </span>	ปฺจ ปจฺเจกพุทฺธานํ         สตานิ สมุปฏฺ€หิ ๑ ฯ  
<span class="LineNumber"> 003 </span>	เตมาสํ วาสยิตฺวาน ๒      อทาสิ ๓ จ ติจีวรํ  
<span class="LineNumber"> 004 </span>	ชายา ตสฺส ตทา อาสึ       ปุฺกมฺมปถานุคา ฯ  
<span class="LineNumber"> 005 </span>	ตโต จุโต อหุ ราชา        นนฺโท นาม มหายโส  
<span class="LineNumber"> 006 </span>	ตสฺสาปิ มเหสี อาสึ         สพฺพกามสมิทฺธินี ฯ  
<span class="LineNumber"> 007 </span>	ตโต ๔ อหุ จวิตฺวาน       พฺรหฺมทตฺโต มหีปติ  
<span class="LineNumber"> 008 </span>	ปทุมาวติปุตฺตานํ            ปจฺเจกมุนินํ ตทา ฯ  
<span class="LineNumber"> 009 </span>	สตานิ ปฺจนูนานิ           ยาวชีวํ อุปฏฺ€หึ  
<span class="LineNumber"> 010 </span>	ราชุยฺยาเน นิวาเสตฺวา      นิพฺพุตานิ จ ปูชยึ ฯ  
<span class="LineNumber"> 011 </span>	เจติยานิ จ กาเรตฺวา       ปพฺพชิตฺวา อุโภ มยํ  
<span class="LineNumber"> 012 </span>	ภาเวตฺวา อปฺปมฺาโย      พฺรหฺมโลกํ อคมฺหเส ฯ  
<span class="LineNumber"> 013 </span>	ตโต จุโต มหาติตฺเถ        สุชาโต ปิปฺผลายโน  
<span class="LineNumber"> 014 </span>	มาตา สุมนเทวี จ          โกสิโคตฺโต ทิโช ปิตา ฯ  
<span class="LineNumber"> 015 </span>	อหํ มทฺเท ชนปเท          สากลายํ ปุรุตฺตเม  
<span class="LineNumber"> 016 </span>	กปิลสฺส ทิชสฺสาสึ           ธีตา มาตา สุจีมติ ฯ  
<span class="LineNumber"> 017 </span>	ฆนกฺจนพิมฺเพน            นิมฺมินิตฺวาน มํ ปิตา  
<span class="LineNumber"> 018 </span>	อทา กสฺสปธีรสฺส           กาเมหิ ๕ วชฺชิตสฺส จ ฯ  
<span class="LineNumber"> 019 </span>	กทาจิ โส ตรุณิโก ๖       คนฺตฺวา กมฺมนฺตเปกฺขโก  
<span class="LineNumber"> 020 </span>	กากาทิเกหิ ขชฺชนฺเต        ปาเณ ทิสฺวาน สํวิชิ ฯ  
<span class="LineNumber"> 021 </span>#๑ ยุ. สมุปฏฺ€หึ ฯ ๒ ม. ตปฺปยิตฺวาน ฯ ๓ ยุ. อทํสุ จ ติจีวเร ฯ ๔ ม. ตโต  
<span class="LineNumber"> 022 </span>#ราชา ภวิตฺวาน ฯ ยุ. จุโต ฯ ๕ ยุ. กามา สา วชฺชิตสฺส เม ฯ ๖ ม. ยุ. การุณิโก ฯ  
