<span class="LineNumber"> 001 </span>	ตทา มุทิตจิตฺตาหํ           ตํ €านํ อภิกงฺขยึ  
<span class="LineNumber"> 002 </span>	นิมนฺเตตฺวา ทสพลํ          สสงฺฆํ โลกนายกํ ฯ  
<span class="LineNumber"> 003 </span>	โภชยิตฺวาน สตฺตาหํ         ททิตฺวา ๑ ปตฺตจีวรํ  
<span class="LineNumber"> 004 </span>	นิปจฺจ สิรสา ปาเท         อิมํ วจนมพฺรวึ ฯ  
<span class="LineNumber"> 005 </span>	ยา ตยา วณฺณิตา ธีร        อิโต อฏฺ€มเก มุนิ ๒  
<span class="LineNumber"> 006 </span>	ตาทิสาหํ ภวิสฺสามิ          ยทิ สิชฺฌติ นายก ฯ  
<span class="LineNumber"> 007 </span>	ตทา อโวจ มํ สตฺถา        ภทฺเท มา ภายิ อสฺสุํ  
<span class="LineNumber"> 008 </span>	อนาคตมฺหิ อทฺธาเน         ลจฺฉเสตํ มโนรถํ ฯ  
<span class="LineNumber"> 009 </span>	สตสหสฺเส อิโต กปฺเป       โอกฺกากกุลสมฺภโว(  
<span class="LineNumber"> 010 </span>	โคตโม นาม นาเมน        สตฺถา โลเก ภวิสฺสติ ฯ  
<span class="LineNumber"> 011 </span>	ตสฺส ธมฺเมสุ ทายาทา       โอรสา ธมฺมนิมฺมิตา  
<span class="LineNumber"> 012 </span>	ปฏาจาราติ นาเมน         เหสฺสติ สตฺถุสาวิกา ฯ  
<span class="LineNumber"> 013 </span>	ตทาหํ มุทิตา หุตฺวา         ยาวชีวํ ตทา ชินํ  
<span class="LineNumber"> 014 </span>	เมตฺตจิตฺตา ปริจรึ          สสงฺฆํ โลกนายกํ ฯ  
<span class="LineNumber"> 015 </span>	เตน กมฺเมน สุกเตน        เจตนาปณิธีหิ จ  
<span class="LineNumber"> 016 </span>	ชหิตฺวา มานุสํ เทหํ         ตาวตึสํ อคฺฉหํ ฯ  
<span class="LineNumber"> 017 </span>	อิมมฺหิ ภทฺทเก กปฺเป        พฺรหฺมพนฺธุ มหายโส  
<span class="LineNumber"> 018 </span>	กสฺสโป นาม นาเมน        อุปฺปชฺชิ วทตํ วโร ฯ  
<span class="LineNumber"> 019 </span>	อุปฏฺ€าโก มเหสิสฺส         ตทา อาสิ นริสฺสโร  
<span class="LineNumber"> 020 </span>	กาสิราชา กิกี นาม         พาราณสิปุรุตฺตเม ฯ  
<span class="LineNumber"> 021 </span>#๑ ม. ททิตฺวาว ติจีวรํ ฯ ยุ. ททิตฺวา จ ติจีวรํ ฯ ๒ ยุ. ทิเน ฯ  
