<span class="LineNumber"> 001 </span>	วรุโณ พฺรหฺมเทโว จ         อเหสุํ อคฺคสาวกา  
<span class="LineNumber"> 002 </span>	สมฺภโว นามุปฏฺ€าโก         เรวตสฺส มเหสิโน ฯ  
<span class="LineNumber"> 003 </span>	ภทฺทา เจว สุภทฺทา จ        อเหสุํ อคฺคสาวิกา  
<span class="LineNumber"> 004 </span>	โสปิ พุทฺโธ อสมสโม         นาคมูเล อพุชฺฌถ ฯ  
<span class="LineNumber"> 005 </span>	วรุโณ ๑ จ สรโภ จ        อเหสุํ อคฺคุปฏฺ€กา  
<span class="LineNumber"> 006 </span>	ปาลา ๒ จ อุปปาลา จ      อเหสุํ อคฺคุปฏฺ€ิกา ฯ  
<span class="LineNumber"> 007 </span>	อุจฺจตฺตเนน โส พุทฺโธ        อสีติหตฺถมุคฺคโต  
<span class="LineNumber"> 008 </span>	โอภาเสสิ ๓ ทิสา สพฺพา     อินฺทเกตุว อุคฺคโต ฯ  
<span class="LineNumber"> 009 </span>	ตสฺส สรีเร นิพฺพตฺตา         ปภามาลา อนุตฺตรา  
<span class="LineNumber"> 010 </span>	ทิวา วา ยทิวา รตฺตึ         สมนฺตา ผรติ ๔ โยชนํ ฯ  
<span class="LineNumber"> 011 </span>	สฏฺ€ิวสฺสสหสฺสานิ            อายุ วิชฺชติ ตาวเท  
<span class="LineNumber"> 012 </span>	ตาวตา ติฏฺ€มาโน โส        ตาเรสิ ชนตํ พหุํ ฯ  
<span class="LineNumber"> 013 </span>	ทสฺสยิตฺวา พุทฺธพลํ           อมตํ โลเก ปกาสยิ ๕  
<span class="LineNumber"> 014 </span>	นิพฺพาสิ อนุปาทาโน          ยถคฺคุปาทานสงฺขยา ฯ  
<span class="LineNumber"> 015 </span>	โส จ กาโย รตนนิโภ        โส จ ธมฺโม อสาทิโส  
<span class="LineNumber"> 016 </span>	สพฺพํ สมนฺตรหิตํ             นนุ ริตฺตา สพฺพสงฺขาราติ ฯ  
<span class="LineNumber"> 017 </span>	เรวโต ยสธโร พุทฺโธ        นิพฺพุโต โส มหาปุฺโ ๖  
<span class="LineNumber"> 018 </span>	ธาตุวิตฺถาริกํ อาสิ           เตสุ เตสุ ปเทสโตติ ฯ  
<span class="LineNumber"> 019 </span>		    เรวตพุทฺธวํโส ปฺจโม ฯ  
<span class="LineNumber"> 020 </span>#๑ ม. ยุ. ปทุโม กุฺชโร เจว ฯ ๒ ม. ยุ. สิริมา เจว ยสวตี ฯ ๓ ม. ยุ.  
<span class="LineNumber"> 021 </span>#โอภาเสติ ฯ ๔ ยุ. ผริ ฯ ๕ ม. ยุ. ปกาสยํ ฯ ๖ ม. มหาปุเร ฯ ยุ. มหามุนิ ฯ  
