<span class="LineNumber"> 001 </span>	ปุนาปรํ พฺรหารฺา          นิกฺขมิตฺวา สาติภิ  
<span class="LineNumber"> 002 </span>	ปวิสามิ ปุรํ รมฺมํ            เชตุตฺตรปุรุตฺตมํ ฯ  
<span class="LineNumber"> 003 </span>	รตนานิ สตฺต วสฺสึสุ          มหาเมโฆ ปวสฺสถ  
<span class="LineNumber"> 004 </span>	ตทาปิ ป€วี กมฺปิ            สิเนรุวนวฏํสกา ฯ  
<span class="LineNumber"> 005 </span>	อเจตนายํ ป€วี             อวิฺาย สุขํ ทุกฺขํ  
<span class="LineNumber"> 006 </span>	สาปิ ทานพลา มยฺหํ          สตฺตกฺขตฺตุมกมฺปถาติ ฯ  
<span class="LineNumber"> 007 </span>		     เวสฺสนฺตรจริยํ นวมํ ฯ  
<span class="LineNumber"> 008 </span>		       ทสมํ สสปณฺฑิตจริยํ  
<span class="LineNumber"> 009 </span>	[๑๐] ปุนาปรํ ยทา โหมิ           สสโก ปวนจาริโก ๑  
<span class="LineNumber"> 010 </span>	ติณปณฺณสากผลภกฺโข          ปรเห€นวิวชฺชิโต ฯ  
<span class="LineNumber"> 011 </span>	มกฺกโฏ จ สิงฺคาโล จ        สุตฺตโปโต ๒ จหํ ตทา  
<span class="LineNumber"> 012 </span>	วสาม เอกสมคฺคา ๓        สายํ ปาโต จ ทิสฺสเร ๔ ฯ  
<span class="LineNumber"> 013 </span>	อหนฺเต อนุสาสามิ           กิริเย กลฺยาณปาปเก  
<span class="LineNumber"> 014 </span>	ปาปานิ ปริวชฺเชถ           กลฺยาเณ อภินิวิสฺสถ ฯ  
<span class="LineNumber"> 015 </span>	อุโปสถมฺหิ ทิวเส            จนฺทํ ทิสฺวาน ปูริตํ  
<span class="LineNumber"> 016 </span>	เอเตสํ ตตฺถ อาจิกฺขึ ๕      ทิวโส อชฺชุโปสโถ ฯ  
<span class="LineNumber"> 017 </span>	ทานานิ ปฏิยาเทถ           ทกฺขิเณยฺยสฺส ทาตเว  
<span class="LineNumber"> 018 </span>	ทตฺวา ทานํ ทกฺขิเณยฺเย ๖    อุปวสฺสถุโปสถํ ฯ  
<span class="LineNumber"> 019 </span>#๑ ม. ปวนจารโก ฯ ๒ ม. อุทฺทโปโต ฯ ๓ ม. ยุ. เอกสมนฺตา ฯ ๔ ยุ.  
<span class="LineNumber"> 020 </span>#ปทิสฺสเร ฯ ๕ ยุ. อาจิกฺขิ ฯ ๖ ยุ. ทกฺขิเณยฺยํ ฯ  
