<span class="LineNumber"> 001 </span>	นนฺทมาตา จ อุตฺตรา         อคฺคา เหสฺสนฺตุปฏฺ€ิกา  
<span class="LineNumber"> 002 </span>	อายุ วสฺสสตํ ตสฺส           โคตมสฺส ยสสฺสิโน ฯ  
<span class="LineNumber"> 003 </span>	อิทํ สุตฺวาน วจนํ            อสมสฺส มเหสิโน  
<span class="LineNumber"> 004 </span>	อาโมทิตา นรมรู            พุทฺธวีชงฺกุโร อยํ ฯ  
<span class="LineNumber"> 005 </span>	อุกฺกุฏฺ€ิสทฺทา วตฺตนฺติ         อปฺโผเฏนฺติ หสนฺติ จ  
<span class="LineNumber"> 006 </span>	กตฺชลี นมสฺสนฺติ            ทสสหสฺสี สเทวกา ฯ  
<span class="LineNumber"> 007 </span>	ยทิมสฺส โลกนาถสฺส          วิรชฺฌิสฺสาม สาสนํ  
<span class="LineNumber"> 008 </span>	อนาคตมฺหิ อทฺธาเน          เหสฺสาม สมฺมุขา อิมํ ฯ  
<span class="LineNumber"> 009 </span>	ยถา มนุสฺสา นทึ ตรนฺตา      ปฏิติตฺถํ วิรชฺฌิย  
<span class="LineNumber"> 010 </span>	เหฏฺ€าติตฺถํ คเหตฺวาน        อุตฺตรนฺติ มหานทึ ฯ  
<span class="LineNumber"> 011 </span>	เอวเมว มยํ สพฺเพ          ยทิ มุฺจามิมํ ชินํ  
<span class="LineNumber"> 012 </span>	อนาคตมฺหิ อทฺธาเน          เหสฺสาม สมฺมุขา อิมํ ฯ  
<span class="LineNumber"> 013 </span>	ตสฺสาปิ วจนํ สุตฺวา          ภิยฺโย จิตฺตํ ปสาทยึ  
<span class="LineNumber"> 014 </span>	อุตฺตรึ วตฺตมธิฏฺ€าสึ          ทสปารมิปูริยา ฯ  
<span class="LineNumber"> 015 </span>	นครํ เขมวตี นาม           เขโม นามาสหํ ตทา  
<span class="LineNumber"> 016 </span>	สพฺพฺุตํ คเวสนฺโต          ปพฺพชึ ตสฺส สนฺติเก ฯ  
<span class="LineNumber"> 017 </span>	พฺราหฺมโณ อคฺคิทตฺโต จ       อาสิ พุทฺธสฺส โส ปิตา  
<span class="LineNumber"> 018 </span>	วิสาขา นาม ชนิกา          กุกฺกุสนฺธสฺส มเหสิโน ๑ ฯ  
<span class="LineNumber"> 019 </span>	วสติ ตตฺถ เขมปุเร          สมฺพุทฺธสฺส มหากุลํ  
<span class="LineNumber"> 020 </span>	นรานํ ปวรํ เสฏฺ€ํ           ชาติมนฺตํ มหายสํ ฯ  
<span class="LineNumber"> 021 </span>	จตุวสฺสสหสฺสานิ             อคารํ อชฺฌาวสิ โส  
<span class="LineNumber"> 022 </span>#๑ ม. สตฺถุโน ฯ  
