<span class="LineNumber"> 001 </span>	พหุทุสฺสวรํ ทตฺวา            ทุสฺสโกฏึ อนปฺปกํ  
<span class="LineNumber"> 002 </span>	อลงฺกตํ หตฺถิยานํ            สมฺพุทฺธสฺส อทาสหํ ฯ  
<span class="LineNumber"> 003 </span>	หตฺถิยานํ นิมฺมินิตฺวา          กปฺปิยํ อุปนามยึ  
<span class="LineNumber"> 004 </span>	ปูรยึ มานสํ มยฺหํ            นิจฺจํ ทฬฺหมุปฏฺ€ิตํ ฯ  
<span class="LineNumber"> 005 </span>	โสปิ มํ พุทฺโธ พฺยากาสิ       สิขี โลกคฺคนายโก  
<span class="LineNumber"> 006 </span>	เอกตฺตึเส อิโต กปฺเป        อยํ พุทฺโธ ภวิสฺสติ ฯ  
<span class="LineNumber"> 007 </span>	อหุ กปิลวฺหยา รมฺมา ๑      นิกฺขมิตฺวา ตถาคโต  
<span class="LineNumber"> 008 </span>	ปธานํ ปทหิตฺวาน            กตฺวา ทุกฺกรการิกํ ฯ  
<span class="LineNumber"> 009 </span>	อชปาลรุกฺขมูลสฺมึ            นิสีทิตฺวา ตถาคโต  
<span class="LineNumber"> 010 </span>	ตตฺถ ปายาสํ ปคฺคยฺห         เนรฺชรมุเปหิติ ฯ  
<span class="LineNumber"> 011 </span>	เนรฺชราย ตีรมฺหิ           ปายาสํ อทิ โส ชิโน  
<span class="LineNumber"> 012 </span>	ปฏิยตฺตวรมคฺเคน            โพธิมูลมฺหิ เอหิติ ฯ  
<span class="LineNumber"> 013 </span>	ตโต ปทกฺขิณํ กตฺวา          โพธิมณฺฑํ อนุตฺตรํ  
<span class="LineNumber"> 014 </span>	อสฺสตฺถรุกฺขมูลมฺหิ            พุชฺฌิสฺสติ มหายโส ฯ  
<span class="LineNumber"> 015 </span>	อิมสฺส ชนิกา มาตา          มายา นาม ภวิสฺสติ  
<span class="LineNumber"> 016 </span>	ปิตา สุทฺโธทโน นาม         อยํ เหสฺสติ โคตโม  ฯ  
<span class="LineNumber"> 017 </span>	อนาสวา วีตราคา           สนฺตจิตฺตา สมาหิตา  
<span class="LineNumber"> 018 </span>	โกลิโต อุปติสฺโส จ          อคฺคา เหสฺสนฺติ สาวกา  
<span class="LineNumber"> 019 </span>	อานนฺโท นามุปฏฺ€าโก        อุปฏฺ€ิสฺสติมํ ชินํ ฯ  
<span class="LineNumber"> 020 </span>#๑ ยุ. อหุ กปิลวฺหเย รมฺเม ฯ อิโต ปรํ อีทิสเมว ฯ  
