<span class="LineNumber"> 001 </span>	น เม ยาจกมนุปฺปตฺเต        ปฏิกฺเขโป อนุจฺฉโว  
<span class="LineNumber"> 002 </span>	มา เม ภิชฺชิ สมาทานํ        ทสฺสามิ วิปุลํ คชํ ฯ  
<span class="LineNumber"> 003 </span>	นาคํ คเหตฺวา โสณฺฑาย       ภิงฺคาเร รตนามเย  
<span class="LineNumber"> 004 </span>	ชลํ หตฺเถ อากิริตฺวา         พฺราหฺมณานํ อทํ คชํ ฯ  
<span class="LineNumber"> 005 </span>	ตสฺส ๑ นาเค ปทินฺนมฺหิ      อมจฺจา เอตทพฺรวว  
<span class="LineNumber"> 006 </span>	กึ นุ ตุยฺหํ วรํ นาคํ          ยาจกานํ จ ทสฺสสิ ฯ  
<span class="LineNumber"> 007 </span>	ธฺํ มงฺคลสมฺปนฺนํ           สงฺคามวิชยุตฺตมํ  
<span class="LineNumber"> 008 </span>	ตสฺส ๒ นาเค ปทินฺนมฺหิ      กินฺเต รชฺชํ กริสฺสติ ฯ  
<span class="LineNumber"> 009 </span>	รชฺชมฺปิ เม ทเท สพฺพํ        สรีรํ ทชฺชมตฺตโน  
<span class="LineNumber"> 010 </span>	สพฺพฺุตํ ปิยํ มยฺหํ           ตสฺมา นาคํ อทาสหนฺติ ฯ  
<span class="LineNumber"> 011 </span>		      กุรุธมฺมจริยํ ตติยํ ฯ  
<span class="LineNumber"> 012 </span>		     จตุตฺถํ มหาสุทสฺสนจริยํ  
<span class="LineNumber"> 013 </span>	[๔] กุสาวติมฺหิ นคเร            ยทา อาสึ มหีปติ  
<span class="LineNumber"> 014 </span>	มหาสุทสฺสโน นาม           จกฺกวตฺติ มหพฺพโล ฯ  
<span class="LineNumber"> 015 </span>	ตตฺถาหํ ทิวเส ติกฺขตฺตุํ        โฆสาเปมิ ตหึ ตหึ  
<span class="LineNumber"> 016 </span>	โก กึ อิจฺฉติ ปตฺเถติ         กสฺส กึ ทิยฺยตู ธนํ ฯ  
<span class="LineNumber"> 017 </span>	โก ฉาตโก โก ตสิโต        โก มาลํ โก วิเลปนํ  
<span class="LineNumber"> 018 </span>	นานารตฺตานิ วตฺถานิ         โก นคฺโค ปริทหิสฺสติ  
<span class="LineNumber"> 019 </span>	โก ปเถ ฉตฺตมาเทติ         โกปาหนา มุทู สุภา ฯ  
<span class="LineNumber"> 020 </span>#๑-๒ ยุ. ตสฺมึ ฯ  
