<span class="LineNumber"> 001 </span>	[๙๓๘]   เหตุํ   โลกุตฺตรํ   ธมฺมํ   ปฏิจฺจ   นเหตุ  นโลกุตฺตโร  
<span class="LineNumber"> 002 </span>ธมฺโม อุปฺปชฺชติ เหตุปจฺจยา: ฯ  
<span class="LineNumber"> 003 </span>	[๙๓๙] เหตุยา ตีณิ ฯ  
<span class="LineNumber"> 004 </span>	   เหตุทุกเกนจิวิฺเยฺยทุเก นเหตุทุกนเกนจิวิฺเยฺยทุกํ  
<span class="LineNumber"> 005 </span>	[๙๔๐]  เหตุํ  เกนจิวิฺเยฺยํ  ธมฺมํ ปฏิจฺจ นเหตุ นเกนจิวิฺเยฺโย  
<span class="LineNumber"> 006 </span>ธมฺโม อุปฺปชฺชติ เหตุปจฺจยา: ฯ  
<span class="LineNumber"> 007 </span>	[๙๔๑] เหตุยา นว ฯ  
<span class="LineNumber"> 008 </span>	[๙๔๒]  เหตุํ เกนจินวิฺเยฺยํ ธมฺมํ ปฏิจฺจ นเหตุ นเกนจินวิฺเยฺโย  
<span class="LineNumber"> 009 </span>ธมฺโม อุปฺปชฺชติ เหตุปจฺจยา:  ฯ  
<span class="LineNumber"> 010 </span>	[๙๔๓] เหตุยา นว ฯ  
<span class="LineNumber"> 011 </span>	         เหตุทุกอาสวทุเก นเหตุทุกโนอาสวทุกํ  
<span class="LineNumber"> 012 </span>	[๙๔๔]   เหตุํ   อาสวํ  ธมฺมํ  ปฏิจฺจ  นเหตุ  โนอาสโว  ธมฺโม  
<span class="LineNumber"> 013 </span>อุปฺปชฺชติ เหตุปจฺจยา: ฯ  
<span class="LineNumber"> 014 </span>	[๙๔๕] เหตุยา ปฺจ ฯ  
<span class="LineNumber"> 015 </span>	[๙๔๖]   เหตุํ   โนอาสวํ   ธมฺมํ   ปฏิจฺจ  นนเหตุ  นโนอาสโว  
<span class="LineNumber"> 016 </span>ธมฺโม อุปฺปชฺชติ เหตุปจฺจยา: ฯ  
<span class="LineNumber"> 017 </span>	[๙๔๗] เหตุยา ปฺจ ฯ  
<span class="LineNumber"> 018 </span>	         เหตุทุกสาสวทุเก นเหตุทุกนสาสวทุกํ  
<span class="LineNumber"> 019 </span>	[๙๔๘]   นเหตุํ  สาสวํ  ธมฺมํ  ปฏิจฺจ  นนเหตุ  นสาสโว  ธมฺโม  
<span class="LineNumber"> 020 </span>อุปฺปชฺชติ เหตุปจฺจยา: ฯ  
