<span class="LineNumber"> 001 </span>	       นกุสลตฺติกนสปฺปฏิฆทุเก กุสลตฺติกสปฺปฏิฆทุกํ  
<span class="LineNumber"> 002 </span>	[๕๘๗]   นกุสลํ   นสปฺปฏิฆํ   ธมฺมํ  ปฏิจฺจ  อพฺยากโต  สปฺปฏิโฆ  
<span class="LineNumber"> 003 </span>ธมฺโม อุปฺปชฺชติ เหตุปจฺจยา: ฯ  
<span class="LineNumber"> 004 </span>	[๕๘๘] เหตุยา ฉ ฯ  
<span class="LineNumber"> 005 </span>	[๕๘๙]   นกุสลํ   นอปฺปฏิฆํ   ธมฺมํ  ปฏิจฺจ  อพฺยากโต  อปฺปฏิโฆ  
<span class="LineNumber"> 006 </span>ธมฺโม อุปฺปชฺชติ เหตุปจฺจยา: ฯ  
<span class="LineNumber"> 007 </span>	[๕๙๐] เหตุยา ตีณิ ฯ  
<span class="LineNumber"> 008 </span>	          นกุสลตฺติกนรูปีทุเก กุสลตฺติกรูปีทุกํ  
<span class="LineNumber"> 009 </span>	[๕๙๑]   นกุสลํ   นรูปึ   ธมฺมํ   ปฏิจฺจ  อพฺยากโต  รูปี  ธมฺโม  
<span class="LineNumber"> 010 </span>อุปฺปชฺชติ เหตุปจฺจยา: ฯ  
<span class="LineNumber"> 011 </span>	[๕๙๒] เหตุยา ฉ ฯ  
<span class="LineNumber"> 012 </span>	[๕๙๓]   นกุสลํ   นอรูปึ  ธมฺมํ  ปฏิจฺจ  อพฺยากโต  อรูปี  ธมฺโม  
<span class="LineNumber"> 013 </span>อุปฺปชฺชติ เหตุปจฺจยา: ฯ  
<span class="LineNumber"> 014 </span>	[๕๙๔] เหตุยา ตีณิ ฯ  
<span class="LineNumber"> 015 </span>	        นกุสลตฺติกนโลกิยทุเก กุสลตฺติกโลกิยทุกํ  
<span class="LineNumber"> 016 </span>	[๕๙๕]   นกุสลํ   นโลกิยํ   ธมฺมํ   ปฏิจฺจ   อพฺยากโต  โลกิโย  
<span class="LineNumber"> 017 </span>ธมฺโม อุปฺปชฺชติ เหตุปจฺจยา: ฯ  
<span class="LineNumber"> 018 </span>	[๕๙๖] เหตุยา ปฺจ ฯ  
<span class="LineNumber"> 019 </span>	[๕๙๗]   นกุสลํ   นโลกุตฺตรํ   ธมฺมํ  ปจฺจยา  กุสโล  โลกุตฺตโร  
<span class="LineNumber"> 020 </span>ธมฺโม  อุปฺปชฺชติ  เหตุปจฺจยา:  ... อพฺยากโต โลกุตฺตโร ธมฺโม ... ฯ  
