<span class="LineNumber"> 001 </span>ทั้ง  ๒  คือจะอธิบายให้เป็นไปทางปัญญาก็ได้  หรือจะอธิบายให้เป็นไป
<span class="LineNumber"> 002 </span>ทางกรุณาก็ได้   เมื่ออธิบายไปทางไหน  ก็ควรจัดเข้าไว้ในทางนั้น. 
<span class="LineNumber"> 003 </span>										ส.ป.
<span class="LineNumber"> 004 </span>	ถ.  พระพุทธคุณ  ๙  ก็มี  พระพุทธคุณ   ๓  ก็มี   พระพุทธ-
<span class="LineNumber"> 005 </span>คุณ  ๒  ก็มี  จงแสดงให้เห็นว่า   มีอย่างไร ?
<span class="LineNumber"> 006 </span>	ต.  พระคุณ ๙ คือ
<span class="LineNumber"> 007 </span>	๑.  <B>อรหํ</B>  เป็นพระอรหันต์
<span class="LineNumber"> 008 </span>	๒. <B> สมฺมาสมฺพุทฺโธ</B>  เป็นผู้ตรัสรู้ชอบเอง
<span class="LineNumber"> 009 </span>	๓.  <B>วิชฺชาจรณสมฺปนฺโน</B> เป็นผู้ถึงพร้อมด้วยวิชชาและจรณะ
<span class="LineNumber"> 010 </span>	๔. <B>สุคโต</B>   เป็นผู้เสด็จไปดีแล้ว
<span class="LineNumber"> 011 </span>	๕.  <B>โลกวิทู</B>  เป็นผู้รู้แจ้งโลก
<span class="LineNumber"> 012 </span>	๖. <B>อนุตฺตโร   ปุริสทมฺมสารถิ</B>  เป็นสารถีแห่งบุรุษพึงฝึกได้
<span class="LineNumber"> 013 </span>	      ไม่มีผู้อื่นยิ่งไปกว่า
<span class="LineNumber"> 014 </span>	๗.  <B>สตฺถา   เทวมนุสฺสานํ</B> เป็นศาสดาของเทวดาและมนุษย์
<span class="LineNumber"> 015 </span>  	      ทั้งหลาย
<span class="LineNumber"> 016 </span>	๘.  <B>พุทฺโธ</B>  เป็นผู้ตื่นแล้ว   เป็นผู้เบิกบานแล้ว.
<span class="LineNumber"> 017 </span>	๙.  <B>ภควา</B>   เป็นผู้มีโชค.
<span class="LineNumber"> 018 </span>พระพุทธคุณ  ๓  คือ
<span class="LineNumber"> 019 </span>	๑.  พระปัญญาคุณ
<span class="LineNumber"> 020 </span>	๒.  พระบริสุทธิคุณ
<span class="LineNumber"> 021 </span>	๓.  พระกรุณาคุณ.

