<span class="LineNumber"> 001 </span>	<B>ไปแล้ว กวาดอาศรม ถือเอาหาบสิ่งของออกจากป่าไป  
<span class="LineNumber"> 002 </span>	ครั้งนั้น  เราพักอยู่ในบ้าน และนิคมแห่งละคืน  เข้าไป
<span class="LineNumber"> 003 </span>	ใกล้พระนครจันทวดี โดยลำดับ  สมัยนั้น พระผู้มีพระ
<span class="LineNumber"> 004 </span>	ภาคเจ้า  ผู้นำของโลกพระนามว่า สุเมธะ กำลังรื้อขน
<span class="LineNumber"> 005 </span>	เป็นอันมาก  ทรงแสดงอมตบท   เราได้ผ่านหมู่ชนไป
<span class="LineNumber"> 006 </span>	ถวายบังคมพระชินเจ้า     ผู้เสด็จมาดี      ทำหนังสัตว์
<span class="LineNumber"> 007 </span>	เฉวียงบ่าข้างหนึ่ง   แล้วสรรเสริญพระผู้นำของโลกว่า
<span class="LineNumber"> 008 </span>	พระองค์เป็นพระศาสดา  เป็นจอมเกตุ  เป็นธงชัยและ
<span class="LineNumber"> 009 </span>	เป็นสายัญของหมู่สัตว์      เป็นที่ยึดหน่วง     เป็นที่พึ่ง
<span class="LineNumber"> 010 </span>	และเป็นที่เกาะของหมู่สัตว์    เป็นผู้สูงสุดกว่าประชา.
<span class="LineNumber"> 011 </span>	พระองค์เป็นผู้ฉลาด  เป็นนักปราชญ์ในทัสสนะ  ทรง
<span class="LineNumber"> 012 </span>	ช่วยประชุมชนให้ข้ามพ้นไปได้   ข้าแต่พระมุนี   ผู้อื่น
<span class="LineNumber"> 013 </span>	ที่จะช่วยให้สัตว์ข้ามพ้นไปได้  ยิ่งกว่าพระองค์ไม่มีใน
<span class="LineNumber"> 014 </span>	โลก    สาครแสนลึกที่สุด   ก็พึงอาจที่จะประมาณได้
<span class="LineNumber"> 015 </span>	ด้วยปลายหญ้าคา ข้าแต่พระสัพพัญญู ส่วนพระญาณ
<span class="LineNumber"> 016 </span>	ของพระองค์ ใคร ๆ ไม่อาจประมาณได้เลย  แผ่นดิน
<span class="LineNumber"> 017 </span>	ก็อาจที่จะวางในตราชั่งแล้วกำหนดได้  ข้าแต่พระองค์
<span class="LineNumber"> 018 </span>	ผู้มีจักษุ    แต่สิ่งที่เสมอกับพระปัญญาของพระองค์ไม่
<span class="LineNumber"> 019 </span>	มีเลย    อากาศก็อาจจะวัดได้ด้วยเชือกและนิ้วมือ  ข้า
<span class="LineNumber"> 020 </span>	แต่พระสัพพัญญู   ส่วนศีลของพระองค์ใคร ๆ  ไม่อาจ
<span class="LineNumber"> 021 </span>	จะประมาณได้เลย   น้ำในมหาสมุทร   อากาศและพื้น
<span class="LineNumber"> 022 </span>	ภูมิภาค  ๓  อย่างนี้  ประมาณเอาได้  ข้าแต่พระองค์
<span class="LineNumber"> 023 </span>	ผู้มีจักษุ    พระองค์ย่อมเป็นผู้อันใคร ๆ  จะประมาณ</B>
