<span class="LineNumber"> 001 </span>	      ในปัจจัยที่ไม่ใช่ปุเรชาตปัจจัย        มีวาระ ๖
<span class="LineNumber"> 002 </span>	      ในปัจจัยที่ไม่ใช่ปัจฉาชาตปัจจัย       มี   "    ๖
<span class="LineNumber"> 003 </span>	      ในปัจจัยที่ไม่ใช่อาเสวนปัจจัย         มี   "    ๖
<span class="LineNumber"> 004 </span>	      ในปัจจัยที่ไม่ใช่กัมมปัจจัย           มี   "    ๔
<span class="LineNumber"> 005 </span>	      ในปัจจัยที่ไม่ใช่วิปากปัจจัย          มี   "    ๖
<span class="LineNumber"> 006 </span>	      ในปัจจัยที่ไม่ใช่ฌานปัจจัย            มี   "    ๑
<span class="LineNumber"> 007 </span>	      ในปัจจัยที่ไม่ใช่มัคคปัจจัย           มี   "    ๑
<span class="LineNumber"> 008 </span>	      ในปัจจัยที่ไม่ใช่วิปปยุตตปัจจัย       มี   "    ๖
<span class="LineNumber"> 009 </span>	การนับทั้งสองนี้ แม้นอกนี้ พึงกระทำอย่างที่กล่าวมาแล้ว
<span class="LineNumber"> 010 </span>	แม้สัมปยุตตวาร ก็เหมือนกับ สังสัฏฐวาร
<span class="LineNumber"> 011 </span>	                     ปัญหาวาร
<span class="LineNumber"> 012 </span>	[๓๘๔] อาสวสัมปยุตตธรรม เป็นปัจจัยแก่อาสวสัมปยุตตธรรม โดยเหตุปัจจัย
<span class="LineNumber"> 013 </span>	คือ เหตุทั้งหลายที่เป็นอาสวสัมปยุตตธรรม เป็นปัจจัยแก่สัมปยุตตขันธ์ทั้งหลาย โดย
<span class="LineNumber"> 014 </span>เหตุปัจจัย
<span class="LineNumber"> 015 </span>	อาสวสัมปยุตตธรรม เป็นปัจจัยแก่อาสววิปปยุตตธรรม โดยเหตุปัจจัย
<span class="LineNumber"> 016 </span>	คือ เหตุทั้งหลายที่เป็นอาสวสัมปยุตตธรรม เป็นปัจจัยแก่จิตตสมุฏฐานรูปทั้งหลาย 
<span class="LineNumber"> 017 </span>โดยเหตุปัจจัย โทสะ เป็นปัจจัยแก่โมหะ และจิตตสมุฏฐานรูปทั้งหลาย โดยเหตุปัจจัย
<span class="LineNumber"> 018 </span>	อาสวสัมปยุตตธรรม เป็นปัจจัยแก่อาสวสัมปยุตตธรรม และอาสววิปปยุตตธรรม 
<span class="LineNumber"> 019 </span>โดยเหตุปัจจัย
<span class="LineNumber"> 020 </span>	คือ เหตุทั้งหลายที่เป็นอาสวสัมปยุตตธรรม เป็นปัจจัยแก่สัมปยุตตขันธ์  และ
<span class="LineNumber"> 021 </span>จิตตสมุฏฐานรูปทั้งหลาย โดยเหตุปัจจัย โทสะ เป็นปัจจัยแก่สัมปยุตตขันธ์  โมหะ และ
<span class="LineNumber"> 022 </span>จิตตสมุฏฐานรูปทั้งหลาย โดยเหตุปัจจัย
<span class="LineNumber"> 023 </span>	อาสววิปปยุตตธรรม เป็นปัจจัยแก่อาสววิปปยุตตธรรม โดยเหตุปัจจัย
<span class="LineNumber"> 024 </span>	คือ เหตุทั้งหลายที่เป็นอาสววิปปยุตตธรรม เป็นปัจจัยแก่สัมปยุตตขันธ์  และจิตต-
<span class="LineNumber"> 025 </span>สมุฏฐานรูปทั้งหลาย โดยเหตุปัจจัย โมหะ ที่สหรคตด้วยโทมนัส  ที่สหรคตด้วยวิจิกิจฉา ที่
<span class="LineNumber"> 026 </span>สหรคตด้วยอุทธัจจะ เป็นปัจจัยแก่จิตตสมุฏฐานรูปทั้งหลาย โดยเหตุปัจจัย ปฏิสนธิ
