<span class="LineNumber"> 001 </span>	      ในปัจจัยที่ไม่ใช่ฌานปัจจัย        มี   "     ๑
<span class="LineNumber"> 002 </span>	      ในปัจจัยที่ไม่ใช่มัคคปัจจัย        มี   "     ๑
<span class="LineNumber"> 003 </span>	      ในปัจจัยที่ไม่ใช่สัมปยุตตปัจจัย     มี   "     ๓
<span class="LineNumber"> 004 </span>	      ในปัจจัยที่ไม่ใช่วิปปยุตตปัจจัย     มี   "     ๖
<span class="LineNumber"> 005 </span>	      ในปัจจัยที่ไม่ใช่นัตถิปัจจัย        มี   "     ๓
<span class="LineNumber"> 006 </span>	      ในปัจจัยที่ไม่ใช่วิคตปัจจัย        มี   "     ๓
<span class="LineNumber"> 007 </span>	[๕๓๒] ในปัจจัยที่ไม่ใช่อารัมมณปัจจัย
<span class="LineNumber"> 008 </span>	      กับเหตุปัจจัย                 มีวาระ ๓
<span class="LineNumber"> 009 </span>	      ในปัจจัยที่ไม่ใช่อธิปติปัจจัย
<span class="LineNumber"> 010 </span>	      กับ ฯลฯ                    มี   "     ๙
<span class="LineNumber"> 011 </span>	                   พึงนับอย่างนี้ ฯ
<span class="LineNumber"> 012 </span>	      ในปัจจัยที่ไม่ใช่วิคตปัจจัย
<span class="LineNumber"> 013 </span>	      กับ ฯลฯ                     มี   "     ๓
<span class="LineNumber"> 014 </span>	[๕๓๓] ในอารัมมณปัจจัย
<span class="LineNumber"> 015 </span>	      กับปัจจัยที่ไม่ใช่เหตุปัจจัย        มีวาระ ๑
<span class="LineNumber"> 016 </span>	      ในอวิคตปัจจัย        กับ ฯลฯ  มี   "     ๑
<span class="LineNumber"> 017 </span>	แม้สหชาตวาร ก็พึงกระทำอย่างที่กล่าวมาแล้ว
<span class="LineNumber"> 018 </span>	                     ปัจจยวาร
<span class="LineNumber"> 019 </span>	[๕๓๔] คันถสัมปยุตตธรรม อาศัยคันถสัมปยุตตธรรม เกิดขึ้น  เพราะเหตุปัจจัย
<span class="LineNumber"> 020 </span>	มี ๓ นัย เหมือนกับ ปฏิจจวาร
<span class="LineNumber"> 021 </span>	คันถวิปปยุตตธรรม อาศัยคันถวิปปยุตตธรรม เกิดขึ้น เพราะเหตุปัจจัย
<span class="LineNumber"> 022 </span>	คือ อาศัยขันธ์ ๑ ที่เป็นคันถวิปปยุตตธรรม ฯลฯ
<span class="LineNumber"> 023 </span>	ในปฏิสนธิขณะ หทัยวัตถุ อาศัยขันธ์ทั้งหลาย ขันธ์ทั้งหลาย อาศัยหทัยวัตถุ มหา-
<span class="LineNumber"> 024 </span>ภูตรูป ๑ ฯลฯ ขันธ์ทั้งหลายที่เป็นคันถวิปปยุตตธรรม อาศัยหทัยวัตถุ
<span class="LineNumber"> 025 </span>	คันถสัมปยุตตธรรม อาศัยคันถวิปปยุตตธรรม เกิดขึ้น เพราะเหตุปัจจัย
