<span class="LineNumber"> 001 </span>	จักขุ ฯลฯ หทัยวัตถุ ฯลฯ ขันธ์ทั้งหลายที่เป็นปรามัฏฐธรรม แต่ไม่ใช่ปรามาสธรรม 
<span class="LineNumber"> 002 </span>โดยความเป็นของไม่เที่ยง ฯลฯ โทมนัส เกิดขึ้น
<span class="LineNumber"> 003 </span>	บุคคลเห็นรูปด้วยทิพยจักขุ ตลอดถึงอาวัชชนะ พึงกระทำทั้งหมด
<span class="LineNumber"> 004 </span>	ธรรมที่เป็นปรามัฏฐธรรม แต่ไม่ใช่ปรามาสธรรม เป็นปัจจัยแก่ธรรมที่เป็นทั้งปรามาส-
<span class="LineNumber"> 005 </span>ธรรม และปรามัฏฐธรรม โดยอารัมมณปัจจัย
<span class="LineNumber"> 006 </span>	คือ ทาน ฯลฯ ศีล ฯลฯ อุโบสถกรรม ฯลฯ
<span class="LineNumber"> 007 </span>	กุศลกรรมทั้งหลายที่เคยสั่งสมไว้แล้วในกาลก่อน ฯลฯ
<span class="LineNumber"> 008 </span>	จากฌาน ฯลฯ
<span class="LineNumber"> 009 </span>	จักขุ ฯลฯ หทัยวัตถุ ฯลฯ บุคคลย่อมยินดี ย่อมเพลิดเพลินยิ่ง ซึ่งขันธ์ทั้งหลายที่
<span class="LineNumber"> 010 </span>เป็นปรามัฏฐธรรม แต่ไม่ใช่ปรามาสธรรม เพราะปรารภจักขุเป็นต้นนั้น  ทิฏฐิ ฯลฯ
<span class="LineNumber"> 011 </span>	ธรรมที่เป็นปรามัฏฐธรรม แต่ไม่ใช่ปรามาสธรรม เป็นปัจจัยแก่ธรรมที่เป็นทั้งปรามาส
<span class="LineNumber"> 012 </span>ธรรม แต่ไม่ใช่ปรามาสธรรมและปรามัฏฐธรรม และธรรมที่เป็นปรามัฏฐธรรม โดยอารัมมณปัจจัย
<span class="LineNumber"> 013 </span>	คือ ทาน ฯลฯ ศีล ฯลฯ อุโบสถกรรม ฯลฯ
<span class="LineNumber"> 014 </span>	กุศลกรรมทั้งหลายที่เคยสั่งสมไว้แล้วในกาลก่อน ฯลฯ
<span class="LineNumber"> 015 </span>	จากฌาน ฯลฯ
<span class="LineNumber"> 016 </span>	จักขุ ฯลฯ หทัยวัตถุ ฯลฯ บุคคลพิจารณาเห็นขันธ์ทั้งหลายที่เป็นปรามัฏฐธรรม แต่
<span class="LineNumber"> 017 </span>ไม่ใช่ปรามาสธรรม โดยความเป็นของไม่เที่ยง ฯลฯ ย่อมยินดี  ย่อมเพลิดเพลินยิ่ง เพราะปรารภ
<span class="LineNumber"> 018 </span>จักขุเป็นต้นนั้น ปรามาสธรรม และสัมปยุตตขันธ์ทั้งหลาย เกิดขึ้น
<span class="LineNumber"> 019 </span>	ทั้ง ๓ นัยแม้นอกนี้ พึงกระทำว่าเพราะปรารภ
<span class="LineNumber"> 020 </span>	ทุกะนี้ เหมือนกับปรามาสทุกะ โลกุตตระไม่ได้ในที่ใด ก็ไม่พึงกระทำในที่นั้น
<span class="LineNumber"> 021 </span>	                ปรามาสปรามัฏฐทุกะ จบ
