<span class="LineNumber"> 001 </span>	      ในปัจจัยที่ไม่ใช่นัตถิปัจจัย
<span class="LineNumber"> 002 </span>	      กับ ฯลฯ                      มี   "     ๓
<span class="LineNumber"> 003 </span>	      ในปัจจัยที่ไม่ใช่วิคตปัจจัย
<span class="LineNumber"> 004 </span>	      กับ ฯลฯ                      มี   "     ๓
<span class="LineNumber"> 005 </span>	[๖๖๘] ในอารัมมณปัจจัย
<span class="LineNumber"> 006 </span>	      กับปัจจัยที่ไม่ใช่เหตุปัจจัย          มีวาระ ๑
<span class="LineNumber"> 007 </span>	      ในอนันตรปัจจัย  กับ ฯลฯ         มี   "     ๑
<span class="LineNumber"> 008 </span>	      ในปัจจัยทั้งปวง  กับ ฯลฯ         มี   "     ๑
<span class="LineNumber"> 009 </span>	      ในอวิคตปัจจัย   กับ ฯลฯ         มี   "     ๑
<span class="LineNumber"> 010 </span>	แม้สหชาตวาร ก็เหมือนกับ ปฏิจจวาร
<span class="LineNumber"> 011 </span>	                     ปัจจยวาร
<span class="LineNumber"> 012 </span>	[๖๖๙] ธรรมที่ไม่ใช่ปรามาสธรรม อาศัยปรามาสธรรม เกิดขึ้น  เพราะเหตุปัจจัย
<span class="LineNumber"> 013 </span>	คือ สัมปยุตตขันธ์และจิตตสมุฏฐานรูปทั้งหลาย อาศัยปรามาสธรรม
<span class="LineNumber"> 014 </span>	ธรรมที่ไม่ใช่ปรามาสธรรม อาศัยธรรมที่ไม่ใช่ปรามาสธรรม เกิดขึ้น  เพราะเหตุปัจจัย
<span class="LineNumber"> 015 </span>	คือ ขันธ์ ๓ และจิตตสมุฏฐานรูป อาศัยขันธ์ ๑ ที่ไม่ใช่ปรามาสธรรม ขันธ์ ๒ ฯลฯ 
<span class="LineNumber"> 016 </span>ปฏิสนธิ  ตลอดถึงอัชฌัตติกมหาภูตรูป   ขันธ์ทั้งหลายที่ไม่ใช่ปรามาสธรรม  อาศัยหทัยวัตถุ
<span class="LineNumber"> 017 </span>	ปรามาสธรรม อาศัยธรรมที่ไม่ใช่ปรามาสธรรม เกิดขึ้น เพราะเหตุปัจจัย
<span class="LineNumber"> 018 </span>	คือ ปรามาสธรรม อาศัยขันธ์ทั้งหลายที่ไม่ใช่ปรามาสธรรม ปรามาสธรรม  อาศัย
<span class="LineNumber"> 019 </span>หทัยวัตถุ
<span class="LineNumber"> 020 </span>	ปรามาสธรรม และธรรมที่ไม่ใช่ปรามาสธรรม อาศัยธรรมที่ไม่ใช่ปรามาสธรรม เกิดขึ้น 
<span class="LineNumber"> 021 </span>เพราะเหตุปัจจัย
<span class="LineNumber"> 022 </span>	คือ ขันธ์ ๓ และปรามาสธรรม และจิตตสมุฏฐานรูป อาศัยขันธ์ ๑  ที่ไม่ใช่ปรามาส-
<span class="LineNumber"> 023 </span>ธรรม ขันธ์ ๒ ฯลฯ ปรามาสธรรม อาศัยหทัยวัตถุ  จิตตสมุฏฐานรูป อาศัยมหาภูตรูปทั้งหลาย 
<span class="LineNumber"> 024 </span>ปรามาสธรรม   และสัมปยุตตขันธ์ทั้งหลาย อาศัยหทัยวัตถุ
<span class="LineNumber"> 025 </span>	ธรรมที่ไม่ใช่ปรามาสธรรม อาศัยปรามาสธรรม และธรรมที่ไม่ใช่ปรามาสธรรม   เกิดขึ้น 
<span class="LineNumber"> 026 </span>เพราะเหตุปัจจัย
